contig	position	variantID	refAllele	altAllele	refCount	altCount	totalCount	lowMAPQDepth	lowBaseQDepth	rawDepth	otherBases	improperPairs
1	6318938	.	G	T	46	8	54	0	1	55	0	0
1	9790067	.	T	C	9	3	12	0	0	12	0	0
1	9966010	.	A	G	3	2	5	0	0	5	0	0
1	10101253	.	T	C	2	6	8	0	0	8	0	0
1	10101830	.	T	C	4	2	6	0	0	6	0	0
1	13636181	.	G	A	6	3	9	0	3	12	0	0
1	13695233	.	T	C	5	3	8	0	0	8	0	0
1	13695260	.	T	C	3	1	4	0	0	4	0	0
1	13695965	.	T	C	3	6	9	0	0	9	0	0
1	13696043	.	T	C	9	2	11	0	1	12	0	0
1	16717060	.	T	C	2	4	6	0	1	7	0	0
1	22031785	.	T	C	4	6	10	0	0	10	0	0
1	33779873	.	C	T	7	4	11	0	2	13	0	0
1	37482239	.	T	C	10	2	12	0	0	12	0	0
1	39695886	.	A	G	3	2	5	0	0	5	0	0
1	39695983	.	A	G	5	2	7	0	0	7	0	0
1	43788764	.	A	C	1	2	3	0	1	4	0	0
1	43788770	.	A	C	4	3	7	0	0	7	0	0
1	51506146	.	T	C	1	2	3	0	0	3	0	0
1	51507738	.	T	C	0	2	2	0	0	2	0	0
1	52246167	.	A	G	8	2	10	0	0	10	0	0
1	57982191	.	A	C	1	0	1	0	0	1	0	0
1	58002052	.	T	C	1	2	3	0	0	3	0	0
1	58796572	.	G	T	3	1	4	0	0	4	0	0
1	59756998	.	A	G	10	4	14	0	0	14	0	0
1	59913367	.	A	G	49	26	75	0	0	75	0	0
1	60517747	.	A	G	29	29	58	0	2	60	0	0
1	63088766	.	T	C	7	2	9	0	0	9	0	0
1	65314871	.	G	T	9	3	12	0	0	12	0	0
1	65314876	.	G	T	9	3	12	0	0	12	0	0
1	66711873	.	A	G	63	22	85	0	1	86	0	0
1	72665915	.	A	G	2	2	4	0	0	4	0	0
1	75118240	.	A	C	4	1	5	0	0	5	0	0
1	75398649	.	A	G	17	6	23	0	2	25	0	0
1	79681738	.	G	T	1	4	5	0	0	5	0	0
1	86275459	.	T	C	14	5	19	0	0	19	0	0
1	86275650	.	T	C	17	4	21	0	1	22	0	0
1	86275689	.	T	C	27	7	34	0	2	36	0	0
1	86276528	.	T	C	8	4	12	0	0	12	0	0
1	86836917	.	T	C	0	2	2	2	1	5	0	0
1	88187259	.	T	C	0	2	2	0	0	2	0	0
1	88187311	.	C	T	2	3	5	0	0	5	0	0
1	88187695	.	C	T	1	2	3	0	0	3	0	0
1	88188102	.	C	T	1	2	3	0	0	3	0	0
1	88188121	.	A	C	2	2	4	0	0	4	0	0
1	88188277	.	C	G	1	2	3	0	1	4	0	0
1	88188360	.	T	G	1	4	5	0	0	5	0	0
1	88188362	.	C	G	1	4	5	0	0	5	0	0
1	88188444	.	G	C	1	4	5	0	0	5	0	0
1	88188846	.	T	G	1	3	4	0	0	4	0	0
1	88189031	.	G	A	3	2	5	0	0	5	0	0
1	88189462	.	G	A	3	2	5	0	0	5	0	0
1	88189563	.	C	T	2	2	4	0	0	4	0	0
1	88189611	.	A	G	3	2	5	0	0	5	0	0
1	88189641	.	G	C	1	2	3	0	0	3	0	0
1	88189668	.	A	G	3	2	5	0	0	5	0	0
1	88189685	.	C	A	3	2	5	0	0	5	0	0
1	88189707	.	C	T	1	2	3	0	0	3	0	0
1	88191018	.	A	T	3	10	13	0	0	13	0	0
1	88191035	.	T	A	1	10	11	0	0	11	0	0
1	88191237	.	A	C	9	35	44	0	1	45	0	0
1	88191320	.	C	T	7	32	39	0	0	39	0	0
1	88191636	.	A	G	6	35	41	0	1	42	0	0
1	88191710	.	T	C	5	19	24	0	0	24	0	0
1	88191744	.	C	A	19	3	22	0	0	22	0	0
1	88191915	.	C	A	4	23	27	0	0	27	0	0
1	88191993	.	A	G	3	26	29	0	7	36	0	0
1	88192008	.	C	T	26	5	31	0	4	35	0	0
1	88192037	.	T	A	3	20	23	0	0	23	0	0
1	88192048	.	G	C	12	28	40	0	0	40	0	0
1	88192098	.	G	A	33	10	43	0	0	43	0	0
1	88192243	.	A	G	7	22	29	0	1	30	0	0
1	88192700	.	G	A	9	23	32	0	1	33	0	0
1	88192756	.	G	A	12	21	33	0	3	36	0	0
1	88192907	.	G	A	20	5	25	0	0	25	0	0
1	88193031	.	C	G	2	16	18	1	0	19	0	0
1	88193194	.	C	T	2	1	3	0	0	3	0	0
1	88193568	.	A	C	2	4	6	0	0	6	0	0
1	88193917	.	G	A	8	16	24	0	0	24	0	0
1	88194314	.	C	A	15	3	18	0	1	19	0	0
1	88197053	.	T	C	0	2	2	0	0	2	0	0
1	88197991	.	A	G	4	19	23	0	0	23	0	0
1	88200603	.	A	T	8	2	10	0	0	10	0	0
1	88200605	.	C	A	1	9	10	0	0	10	0	0
1	88200653	.	A	C	1	7	8	0	0	8	0	0
1	88200832	.	C	T	2	10	12	0	0	12	0	0
1	88202772	.	A	T	0	2	2	0	0	2	0	0
1	88203670	.	C	T	2	3	5	0	0	5	0	0
1	88204960	.	T	C	2	2	4	2	0	6	0	0
1	91860479	.	C	T	8	2	10	0	0	10	0	0
1	91860480	.	G	T	8	2	10	0	0	10	0	0
1	93299307	.	A	G	5	5	10	0	0	10	0	0
1	93299316	.	A	G	9	2	11	0	0	11	0	0
1	93299351	.	A	G	2	2	4	0	1	5	0	0
1	93299367	.	A	G	1	3	4	0	0	4	0	0
1	106652239	.	C	A	3	13	16	0	7	23	0	0
1	118225697	.	T	C	7	3	10	0	0	10	0	0
1	118226104	.	T	C	5	2	7	0	0	7	0	0
1	118227368	.	C	T	19	6	25	0	0	25	0	0
1	118538782	.	A	G	9	2	11	0	0	11	0	0
1	131953439	.	T	C	24	11	35	0	0	35	0	0
1	131953444	.	T	C	25	5	30	0	0	30	0	0
1	132999447	.	G	T	1	2	3	0	0	3	0	0
1	133067453	.	T	C	1	5	6	0	0	6	0	0
1	135200566	.	T	C	1	2	3	0	0	3	0	0
1	154270351	.	C	A	22	11	33	0	1	34	0	0
1	155151508	.	G	T	6	8	14	0	8	22	0	0
1	155151509	.	C	T	6	3	9	0	13	22	0	0
1	156255182	.	T	C	5	9	14	0	0	14	0	0
1	156255601	.	T	C	2	4	6	0	0	6	0	0
1	160842749	.	T	C	9	2	11	0	0	11	0	0
1	162371513	.	T	C	1	1	2	0	0	2	0	0
1	170020996	.	C	T	0	4	4	0	1	5	0	0
1	178779812	.	T	C	7	3	10	0	0	10	0	0
1	178779824	.	T	C	9	2	11	0	0	11	0	0
1	178779916	.	T	C	10	1	11	0	0	11	0	0
1	178780229	.	T	C	7	3	10	0	0	10	0	0
1	180155279	.	A	G	4	2	6	0	0	6	0	0
1	180924020	.	T	C	20	10	30	0	1	31	0	0
1	180996273	.	A	C	13	3	16	0	6	22	0	0
1	183190495	.	A	G	10	3	13	0	0	13	0	0
1	183190594	.	A	G	12	5	17	0	0	17	0	0
1	192797434	.	C	T	7	2	9	0	0	9	0	0
10	7524278	.	T	C	1	0	1	0	0	1	0	0
10	20194416	.	A	G	1	2	3	0	0	3	0	0
10	29104018	.	G	T	2	3	5	0	3	8	0	0
10	29104019	.	G	T	3	3	6	0	2	8	0	0
10	33791335	.	A	G	0	4	4	0	0	4	0	0
10	33865251	.	T	C	1	4	5	0	0	5	0	0
10	33868452	.	T	C	5	3	8	0	0	8	0	0
10	33868473	.	T	C	6	3	9	0	0	9	0	0
10	49118584	.	T	C	7	6	13	0	0	13	0	0
10	49118640	.	T	C	4	7	11	0	0	11	0	0
10	49148872	.	T	C	1	16	17	0	0	17	0	0
10	49148885	.	T	C	3	22	25	0	0	25	0	0
10	67383355	.	G	A	1	3	4	0	2	6	0	0
10	79993842	.	C	T	7	2	9	0	2	11	0	0
10	80442480	.	T	C	1	0	1	0	2	3	0	0
10	82486613	.	T	C	20	9	29	0	1	30	0	0
10	84951091	.	G	T	7	4	11	0	1	12	0	0
10	85893247	.	T	G	1	1	2	0	1	3	0	0
10	86524792	.	A	G	8	2	10	0	1	11	0	0
10	86672208	.	A	G	6	13	19	0	2	21	0	0
10	88306042	.	T	C	8	2	10	0	1	11	0	0
10	94057224	.	A	G	12	4	16	0	0	16	0	0
10	94057234	.	A	G	10	2	12	0	0	12	0	0
10	115125374	.	G	A	13	4	17	0	5	22	0	0
10	126901722	.	A	G	4	1	5	0	0	5	0	0
10	126903751	.	T	C	52	17	69	0	1	70	0	0
10	127038297	.	T	C	2	3	5	0	0	5	0	0
10	127038306	.	T	C	3	2	5	0	0	5	0	0
10	128032764	.	A	G	2	2	4	0	1	5	0	0
10	128033260	.	A	G	2	2	4	0	1	5	0	0
11	4092085	.	T	C	9	14	23	0	1	24	0	0
11	4092108	.	T	C	24	9	33	0	0	33	0	0
11	4092790	.	T	C	15	12	27	0	1	28	0	0
11	5919668	.	A	T	10	5	15	0	1	16	0	0
11	21273304	.	C	T	0	1	1	0	0	1	0	0
11	23813588	.	C	A	3	2	5	0	0	5	0	0
11	29480155	.	G	A	2	2	4	0	1	5	0	0
11	43572939	.	A	G	6	6	12	0	0	12	0	0
11	43572970	.	A	G	6	2	8	0	0	8	0	0
11	43573028	.	A	G	4	5	9	0	0	9	0	0
11	43574972	.	A	G	1	2	3	0	0	3	0	0
11	43574977	.	A	G	1	2	3	0	0	3	0	0
11	45821425	.	T	C	14	4	18	0	0	18	0	0
11	46163470	.	T	C	34	206	240	0	3	243	0	0
11	57218920	.	A	C	13	6	19	0	6	25	0	0
11	59048472	.	A	G	6	2	8	0	0	8	0	0
11	59347027	.	A	G	12	21	33	0	1	34	0	0
11	59347029	.	A	G	18	16	34	0	0	34	0	0
11	59349201	.	A	G	14	3	17	0	0	17	0	0
11	59349204	.	A	G	16	4	20	0	0	20	0	0
11	59401821	.	A	G	14	2	16	0	0	16	0	0
11	59401881	.	A	G	4	5	9	0	1	10	0	0
11	59628117	.	C	T	6	2	8	0	0	8	0	0
11	60749725	.	A	G	2	2	4	0	0	4	0	0
11	62032236	.	A	G	2	2	4	0	0	4	0	0
11	62032250	.	A	G	3	3	6	0	0	6	0	0
11	66955412	.	A	T	5	2	7	0	1	8	0	0
11	66956044	.	A	G	2	2	4	0	0	4	0	0
11	66956050	.	A	G	2	2	4	0	0	4	0	0
11	68276913	.	G	C	5	0	5	0	0	5	0	0
11	69674128	.	A	G	13	6	19	0	0	19	0	0
11	69922901	.	A	G	6	6	12	0	0	12	0	0
11	69922950	.	A	G	7	2	9	0	0	9	0	0
11	69925276	.	A	G	8	2	10	0	0	10	0	0
11	69925824	.	A	G	3	7	10	0	0	10	0	0
11	69926813	.	A	G	7	4	11	0	0	11	0	0
11	69926817	.	A	G	6	4	10	0	0	10	0	0
11	69927363	.	A	G	1	1	2	0	0	2	0	0
11	69927374	.	A	G	0	2	2	0	0	2	0	0
11	69927869	.	A	G	2	9	11	0	1	12	0	0
11	69927946	.	A	G	9	4	13	0	0	13	0	0
11	69927953	.	A	G	9	4	13	0	0	13	0	0
11	69928014	.	A	G	5	2	7	0	0	7	0	0
11	69937302	.	A	G	6	3	9	0	0	9	0	0
11	70500705	.	C	T	11	3	14	1	0	15	0	0
11	70500706	.	G	A	11	3	14	1	0	15	0	0
11	74747599	.	T	C	2	4	6	0	0	6	0	0
11	75068285	.	T	C	25	4	29	0	0	29	0	0
11	77426880	.	T	C	42	8	50	0	1	51	0	0
11	77750779	.	A	G	4	2	6	0	0	6	0	0
11	78184586	.	A	G	0	3	3	0	0	3	0	0
11	78184587	.	A	G	1	2	3	0	0	3	0	0
11	78186027	.	A	G	6	3	9	0	0	9	0	0
11	78187443	.	A	G	11	4	15	0	0	15	0	0
11	78205233	.	G	C	4	1	5	0	0	5	0	0
11	78588120	.	T	C	6	3	9	0	1	10	0	0
11	82854054	.	A	G	3	2	5	0	1	6	0	0
11	82854486	.	A	G	5	2	7	0	0	7	0	0
11	85082181	.	C	T	2	8	10	0	4	15	1	0
11	87014114	.	A	G	7	2	9	0	1	10	0	0
11	88927208	.	T	C	8	14	22	0	0	22	0	0
11	88928673	.	T	C	3	2	5	0	0	5	0	0
11	94431318	.	T	C	5	7	12	0	0	12	0	0
11	94431502	.	T	C	7	2	9	0	0	9	0	0
11	94431842	.	T	C	9	3	12	0	0	12	0	0
11	94432839	.	T	C	6	2	8	0	0	8	0	0
11	94432859	.	T	C	8	4	12	0	0	12	0	0
11	95722830	.	T	C	5	1	6	0	5	11	0	0
11	97734000	.	A	G	41	6	47	0	2	49	0	0
11	98792156	.	A	G	45	8	53	0	3	56	0	0
11	98794177	.	G	A	13	5	18	0	6	24	0	0
11	100330625	.	T	C	10	2	12	0	0	12	0	0
11	100488792	.	T	C	5	4	9	0	0	9	0	0
11	101089107	.	T	C	5	3	8	0	0	8	0	0
11	101089126	.	T	C	3	4	7	0	0	7	0	0
11	101089507	.	T	C	8	2	10	0	0	10	0	0
11	101089557	.	T	C	13	3	16	0	2	18	0	0
11	101089802	.	T	C	10	7	17	0	0	17	0	0
11	102053496	.	G	A	1	2	3	0	2	5	0	0
11	102053507	.	G	A	1	1	2	0	3	5	0	0
11	106048145	.	C	T	4	2	6	0	0	6	0	0
11	109148241	.	T	C	5	2	7	0	0	7	0	0
11	115883970	.	A	G	2	1	3	0	0	3	0	0
11	116303813	.	T	C	7	4	11	0	1	12	0	0
11	116471963	.	T	C	7	25	32	0	2	34	0	0
11	118928914	.	G	A	6	2	8	0	0	8	0	0
11	119337017	.	C	T	1	1	2	0	0	2	0	0
12	3454168	.	A	G	33	9	42	0	0	42	0	0
12	3454248	.	A	G	13	43	56	0	8	64	0	0
12	11320570	.	A	G	2	0	2	0	0	2	0	0
12	15866673	.	G	A	14	2	16	0	0	16	0	0
12	17479425	.	T	C	5	5	10	0	2	12	0	0
12	17479431	.	G	C	5	4	9	0	2	11	0	0
12	17479686	.	A	G	10	4	14	0	0	14	0	0
12	17479809	.	A	G	12	15	27	0	0	27	0	0
12	17479860	.	A	G	13	3	16	0	0	16	0	0
12	17479886	.	A	G	9	2	11	0	0	11	0	0
12	28753451	.	T	A	2	2	4	0	1	5	0	0
12	31987348	.	T	C	9	2	11	0	0	11	0	0
12	46747117	.	T	C	27	12	39	0	1	40	0	0
12	54718540	.	T	C	10	6	16	0	0	16	0	0
12	54719070	.	T	C	21	7	28	0	0	28	0	0
12	54719142	.	T	C	23	7	30	0	0	30	0	0
12	55095716	.	A	T	9	0	9	0	0	9	0	0
12	55102739	.	T	C	3	2	5	0	0	5	0	0
12	59091368	.	T	C	1	2	3	0	1	4	0	0
12	65113982	.	T	C	6	2	8	0	0	8	0	0
12	69244102	.	A	G	17	4	21	0	0	21	0	0
12	69630559	.	A	G	2	2	4	0	0	4	0	0
12	71000683	.	A	G	1	2	3	0	0	3	0	0
12	71041410	.	A	G	28	6	34	0	0	34	0	0
12	71041903	.	A	G	9	13	22	0	1	23	0	0
12	71041945	.	A	G	17	7	24	0	0	24	0	0
12	72953236	.	T	C	4	2	6	0	0	6	0	0
12	72956113	.	T	C	13	4	17	0	0	17	0	0
12	72956148	.	T	C	1	5	6	0	0	6	0	0
12	72956155	.	T	C	2	4	6	0	0	6	0	0
12	73399716	.	C	A	0	3	3	0	0	3	0	0
12	75678010	.	C	T	1	4	5	3	0	8	0	0
12	80770523	.	A	G	2	2	4	0	0	4	0	0
12	83582758	.	G	A	0	1	1	0	0	1	0	0
12	84724302	.	T	G	2	2	4	0	10	14	0	0
12	84724308	.	T	G	4	1	5	0	12	17	0	0
12	85389418	.	T	G	0	3	3	0	0	3	0	0
12	86726722	.	A	C	9	5	14	0	2	16	0	0
12	86726725	.	T	C	10	6	16	0	1	17	0	0
12	87295728	.	T	C	1	2	3	0	0	3	0	0
12	87467465	.	A	C	0	1	1	0	0	1	0	0
12	87467472	.	G	A	2	2	4	0	0	4	0	0
12	100837974	.	A	G	5	3	8	0	1	9	0	0
12	101886131	.	T	C	15	5	20	0	0	20	0	0
12	101887890	.	T	C	15	4	19	0	0	19	0	0
12	108295479	.	G	A	7	2	9	0	0	9	0	0
12	109511196	.	G	A	16	1	17	0	8	25	0	0
12	109693307	.	A	G	1	2	3	0	0	3	0	0
12	109706996	.	A	G	3	2	5	0	0	5	0	0
12	110944176	.	C	T	6	0	6	0	0	6	0	0
13	3702360	.	A	G	4	2	6	0	0	6	0	0
13	3702375	.	A	G	4	3	7	0	0	7	0	0
13	3702737	.	A	G	6	2	8	0	0	8	0	0
13	4642586	.	A	G	10	3	13	0	1	14	0	0
13	8901801	.	T	C	12	7	19	0	0	19	0	0
13	14225628	.	T	C	27	6	33	0	1	34	0	0
13	14228102	.	T	C	21	5	26	0	2	28	0	0
13	17872306	.	A	G	5	2	7	0	0	7	0	0
13	17978741	.	T	C	6	4	10	0	0	10	0	0
13	17978887	.	T	C	9	3	12	0	2	14	0	0
13	17978929	.	T	C	1	13	14	0	2	16	0	0
13	17978950	.	T	C	4	13	17	0	0	17	0	0
13	17979133	.	T	C	6	6	12	0	1	13	0	0
13	21574169	.	T	C	4	3	7	0	0	7	0	0
13	21574188	.	T	C	7	4	11	0	0	11	0	0
13	21576576	.	T	C	14	3	17	0	1	18	0	0
13	24999535	.	A	G	2	4	6	0	0	6	0	0
13	25389897	.	T	C	7	2	9	0	0	9	0	0
13	51305472	.	A	T	1	0	1	0	20	21	0	0
13	52989163	.	A	G	6	1	7	0	0	7	0	0
13	60910041	.	G	A	10	4	14	0	3	17	0	0
13	63448526	.	A	G	6	3	9	0	0	9	0	0
13	64438124	.	T	C	5	4	9	0	0	9	0	0
13	67620481	.	A	G	2	2	4	0	0	4	0	0
13	67806944	.	T	C	2	2	4	0	0	4	0	0
13	67967727	.	T	C	2	4	6	0	0	6	0	0
13	74092767	.	G	C	5	2	7	0	0	7	0	0
13	75793212	.	C	T	0	7	7	4	0	11	0	0
13	78383266	.	A	G	10	2	12	0	1	13	0	0
13	84443715	.	C	T	7	2	9	0	0	9	0	0
13	100267635	.	T	C	4	2	6	0	3	9	0	0
13	100839326	.	T	C	18	7	25	0	1	26	0	0
13	100839340	.	T	C	17	4	21	0	0	21	0	0
13	119625401	.	G	T	10	9	19	0	1	20	0	0
14	10058181	.	A	G	16	10	26	0	1	27	0	0
14	14533725	.	T	C	0	8	8	0	0	8	0	0
14	14533732	.	T	C	10	1	11	0	0	11	0	0
14	20692036	.	A	G	2	2	4	0	0	4	0	0
14	21846832	.	A	G	13	33	46	0	1	47	0	0
14	21847779	.	A	G	60	13	73	0	0	73	0	0
14	26382413	.	T	C	1	3	4	0	0	4	0	0
14	29788070	.	T	C	5	2	7	0	0	7	0	0
14	29788078	.	T	C	4	2	6	0	0	6	0	0
14	31422583	.	T	C	24	13	37	0	0	37	0	0
14	31422619	.	T	C	16	8	24	0	2	26	0	0
14	32018582	.	A	G	25	6	31	0	2	33	0	0
14	32300088	.	A	G	2	3	5	1	0	6	0	0
14	33953408	.	T	C	8	2	10	0	0	10	0	0
14	47558234	.	A	G	4	3	7	0	0	7	0	0
14	48646472	.	A	G	0	2	2	1	0	3	0	0
14	51013458	.	T	C	6	2	8	0	0	8	0	0
14	51109987	.	A	G	4	3	7	0	0	7	0	0
14	52243661	.	A	C	3	2	5	0	3	8	0	0
14	52531686	.	A	G	23	64	87	0	0	87	0	0
14	54532522	.	G	A	0	2	2	0	0	2	0	0
14	54744923	.	C	T	9	3	12	0	5	17	0	0
14	54744924	.	G	T	9	5	14	0	3	17	0	0
14	54912611	.	T	C	2	2	4	0	0	4	0	0
14	55143813	.	T	C	5	2	7	0	0	7	0	0
14	60414895	.	T	C	9	3	12	0	0	12	0	0
14	60619746	.	G	C	11	4	15	0	3	18	0	0
14	62778153	.	G	A	0	2	2	1	0	3	0	0
14	65291200	.	A	G	14	5	19	0	13	32	0	0
14	65434640	.	T	C	34	18	52	0	0	52	0	0
14	66208572	.	A	C	3	1	4	0	1	5	0	0
14	66208578	.	T	C	1	1	2	0	1	3	0	0
14	70898780	.	A	G	2	2	4	0	0	4	0	0
14	75001438	.	A	G	2	2	4	0	0	4	0	0
14	75957159	.	T	C	9	3	12	0	0	12	0	0
14	79573041	.	C	A	3	2	5	0	0	5	0	0
14	84774500	.	C	A	11	8	19	0	1	20	0	0
14	103376024	.	G	A	3	2	5	0	0	5	0	0
14	103584115	.	T	C	13	16	29	0	0	29	0	0
14	121273016	.	A	G	9	5	14	0	0	14	0	0
14	123864295	.	C	T	8	12	20	0	0	20	0	0
15	8187674	.	A	G	11	5	16	0	0	16	0	0
15	8188973	.	A	G	5	2	7	0	2	9	0	0
15	8245655	.	A	G	2	2	4	0	0	4	0	0
15	27730990	.	C	A	18	5	23	0	0	23	0	0
15	34269632	.	G	A	1	0	1	0	0	1	0	0
15	55118692	.	A	G	8	7	15	0	0	15	0	0
15	58695035	.	T	C	18	3	21	0	0	21	0	0
15	66158075	.	T	C	10	4	14	0	0	14	0	0
15	66652852	.	A	G	8	1	9	0	0	9	0	0
15	68973014	.	C	A	3	4	7	0	2	9	0	0
15	75525427	.	T	C	1	2	3	0	0	3	0	0
15	80816550	.	A	G	5	7	12	0	0	12	0	0
15	81074869	.	A	G	1	2	3	0	0	3	0	0
15	81074873	.	T	G	1	2	3	0	0	3	0	0
15	81338244	.	A	G	13	3	16	0	0	16	0	0
15	81339166	.	A	G	5	6	11	0	0	11	0	0
15	81341097	.	A	G	3	4	7	0	0	7	0	0
15	81733114	.	C	T	1	2	3	0	3	6	0	0
15	81733115	.	C	T	3	2	5	0	1	6	0	0
15	81791419	.	A	G	7	3	10	0	0	10	0	0
15	83542303	.	T	C	1	2	3	0	0	3	0	0
15	93293466	.	A	T	3	0	3	0	0	3	0	0
15	93388677	.	C	G	7	3	10	0	3	13	0	0
15	93388679	.	A	G	7	1	8	0	5	13	0	0
15	95117440	.	A	G	29	14	43	0	41	85	1	0
15	97690661	.	C	T	11	2	13	0	0	13	0	0
15	98634993	.	T	C	14	24	38	0	0	38	0	0
15	98731431	.	T	C	28	9	37	0	0	37	0	0
15	99142536	.	T	C	1	3	4	0	1	5	0	0
15	99626049	.	A	G	7	6	13	0	0	13	0	0
15	99626091	.	A	G	4	6	10	0	0	10	0	0
15	99627261	.	A	G	2	3	5	0	1	6	0	0
15	99627262	.	A	G	3	2	5	0	1	6	0	0
16	4138530	.	T	G	2	2	4	29	0	33	0	0
16	4604755	.	T	C	4	2	6	0	0	6	0	0
16	13520445	.	A	G	15	8	23	0	0	23	0	0
16	13650452	.	A	G	5	4	9	0	0	9	0	0
16	13651947	.	T	C	18	5	23	0	0	23	0	0
16	16844922	.	A	G	8	3	11	0	0	11	0	0
16	16866848	.	A	G	1	2	3	0	0	3	0	0
16	17321752	.	A	G	13	4	17	0	0	17	0	0
16	18653678	.	A	G	32	17	49	0	1	50	0	0
16	19942498	.	A	G	33	35	68	0	1	69	0	0
16	19943076	.	A	G	45	9	54	0	0	54	0	0
16	20215125	.	C	T	3	2	5	0	0	5	0	0
16	20363193	.	A	G	5	2	7	0	0	7	0	0
16	30330773	.	T	C	11	7	18	0	0	18	0	0
16	32118665	.	A	G	15	4	19	0	1	20	0	0
16	32119078	.	A	G	13	6	19	0	0	19	0	0
16	32119106	.	A	G	15	8	23	0	0	23	0	0
16	32119150	.	A	G	5	16	21	0	0	21	0	0
16	38319163	.	G	A	1	3	4	0	1	5	0	0
16	55722120	.	T	C	12	2	14	0	0	14	0	0
16	76087628	.	C	T	10	5	15	0	3	18	0	0
16	87230813	.	T	C	7	6	13	0	0	13	0	0
16	87230814	.	T	C	7	6	13	0	0	13	0	0
16	87737431	.	T	C	1	1	2	0	0	2	0	0
16	91287590	.	A	G	1	3	4	0	0	4	0	0
16	91452977	.	A	G	70	42	112	0	1	113	0	0
16	91453021	.	A	G	71	25	96	0	1	97	0	0
16	95957876	.	G	T	16	5	21	0	3	24	0	0
17	6330948	.	T	C	5	0	5	0	0	5	0	0
17	15695826	.	T	C	4	3	7	0	0	7	0	0
17	15741073	.	A	G	5	4	9	0	0	9	0	0
17	15741577	.	A	G	1	2	3	0	0	3	0	0
17	15741583	.	A	G	1	2	3	0	0	3	0	0
17	24381413	.	T	C	0	2	2	1	0	3	0	0
17	24395416	.	T	C	27	9	36	0	2	38	0	0
17	24395428	.	T	C	23	10	33	0	1	34	0	0
17	24395462	.	T	C	37	11	48	0	1	49	0	0
17	24395463	.	T	C	32	17	49	0	0	49	0	0
17	24397327	.	T	C	6	6	12	0	0	12	0	0
17	24635708	.	A	G	4	2	6	0	0	6	0	0
17	24635786	.	A	G	5	2	7	0	0	7	0	0
17	26502450	.	G	T	30	8	38	0	7	45	0	0
17	28532601	.	C	A	10	1	11	0	0	11	0	0
17	28532602	.	C	T	10	1	11	0	0	11	0	0
17	29521001	.	A	G	6	5	11	0	0	11	0	0
17	32425957	.	T	C	0	1	1	0	0	1	0	0
17	33015482	.	T	C	4	3	7	0	0	7	0	0
17	33552004	.	T	C	7	4	11	0	1	12	0	0
17	33906273	.	T	C	3	3	6	0	0	6	0	0
17	34147531	.	A	G	10	11	21	0	1	22	0	0
17	36168626	.	A	G	6	6	12	0	0	12	0	0
17	40158498	.	T	C	3003	4024	7027	0	108	7489	354	0
17	40159543	.	T	C	35	252	287	0	4	291	0	0
17	43767562	.	A	C	3	2	5	0	0	5	0	0
17	43767568	.	A	C	4	2	6	0	0	6	0	0
17	45973875	.	T	C	11	18	29	0	2	31	0	0
17	46810304	.	A	G	5	4	9	0	0	9	0	0
17	47085857	.	T	C	14	5	19	0	0	19	0	0
17	47085863	.	T	C	16	4	20	0	0	20	0	0
17	56485125	.	C	T	3	2	5	0	0	5	0	0
17	83522784	.	A	C	1	1	2	0	0	2	0	0
17	86962445	.	G	A	60	15	75	0	12	87	0	0
17	90763504	.	G	A	4	2	6	0	0	6	0	0
17	95067396	.	T	C	9	6	15	0	0	15	0	0
17	95067479	.	T	C	8	24	32	0	0	32	0	0
17	95067820	.	T	C	30	5	35	0	0	35	0	0
18	4198498	.	C	T	1	0	1	3	0	4	0	0
18	6792650	.	A	G	22	7	29	0	1	30	0	0
18	6792857	.	A	G	15	6	21	0	0	21	0	0
18	6792866	.	A	G	13	9	22	0	0	22	0	0
18	6793746	.	A	G	20	10	30	0	0	30	0	0
18	6793749	.	A	G	22	7	29	0	0	29	0	0
18	21261539	.	C	T	5	1	6	0	5	11	0	0
18	24098007	.	A	G	4	3	7	0	1	8	0	0
18	24153394	.	T	C	1	1	2	0	0	2	0	0
18	32235557	.	A	G	5	3	8	0	1	9	0	0
18	32235595	.	A	G	3	7	10	0	0	10	0	0
18	32235643	.	A	G	4	4	8	0	0	8	0	0
18	32235652	.	A	G	3	4	7	0	0	7	0	0
18	32235928	.	A	G	3	2	5	0	0	5	0	0
18	32235930	.	A	G	1	4	5	0	0	5	0	0
18	32235964	.	A	G	0	2	2	0	0	2	0	0
18	34998030	.	T	A	2	2	4	0	0	4	0	0
18	35743341	.	A	G	6	5	11	0	0	11	0	0
18	37815629	.	T	C	2	2	4	0	0	4	0	0
18	46299221	.	A	G	1	2	3	0	0	3	0	0
18	62794785	.	A	G	1	2	3	0	0	3	0	0
18	77062550	.	A	G	4	10	14	0	0	14	0	0
18	77062557	.	A	G	10	3	13	0	1	14	0	0
18	80741374	.	A	G	4	1	5	0	0	5	0	0
18	84030232	.	C	T	3	1	4	0	0	4	0	0
18	84030234	.	G	T	3	1	4	0	0	4	0	0
19	3916385	.	A	G	16	4	20	0	0	20	0	0
19	3917362	.	A	G	8	4	12	0	0	12	0	0
19	3940126	.	A	G	2	3	5	0	0	5	0	0
19	4368397	.	A	G	7	2	9	0	10	20	1	0
19	4811035	.	A	G	2	1	3	0	0	3	0	0
19	4811061	.	T	C	6	3	9	0	0	9	0	0
19	4813117	.	T	C	4	3	7	0	0	7	0	0
19	4813159	.	T	C	6	2	8	0	0	8	0	0
19	6895783	.	T	C	2	3	5	0	0	5	0	0
19	7515480	.	A	G	14	5	19	0	0	19	0	0
19	8900145	.	A	G	5	2	7	0	0	7	0	0
19	8920351	.	A	G	1	3	4	0	0	4	0	0
19	10223060	.	T	C	26	51	77	0	0	77	0	0
19	12441626	.	A	G	33	8	41	0	0	41	0	0
19	16255599	.	A	C	0	6	6	0	0	6	0	0
19	16255716	.	A	G	0	6	6	0	0	6	0	0
19	18911215	.	T	A	8	3	11	0	1	12	0	0
19	28997192	.	A	G	23	6	29	0	0	29	0	0
19	29365396	.	T	C	1	1	2	0	1	3	0	0
19	32643020	.	C	T	7	2	9	0	0	9	0	0
19	40288113	.	G	A	0	2	2	0	0	2	0	0
19	43429365	.	A	G	13	3	16	0	0	16	0	0
19	43429601	.	A	G	21	14	35	0	0	35	0	0
19	43429753	.	A	G	33	11	44	0	0	44	0	0
19	44130371	.	T	C	3	3	6	0	0	6	0	0
19	44993669	.	T	C	34	6	40	0	3	43	0	0
19	44993727	.	T	C	45	8	53	0	0	53	0	0
19	56535266	.	C	A	2	1	3	0	0	3	0	0
2	6448875	.	C	T	2	2	4	0	1	5	0	0
2	6549647	.	G	T	7	4	11	0	1	12	0	0
2	10256241	.	A	G	16	2	18	0	0	18	0	0
2	14152860	.	A	G	27	5	32	0	0	32	0	0
2	14153492	.	A	G	4	7	11	0	0	11	0	0
2	14153493	.	A	G	6	5	11	0	0	11	0	0
2	18219472	.	T	C	6	5	11	0	0	11	0	0
2	18219544	.	T	C	7	4	11	0	0	11	0	0
2	18220170	.	T	C	7	3	10	0	0	10	0	0
2	18220174	.	T	C	5	6	11	0	0	11	0	0
2	22478526	.	A	G	0	1	1	3	2	6	0	0
2	22478604	.	G	A	0	2	2	2	0	4	0	0
2	26278314	.	A	G	1	2	3	0	0	3	0	0
2	26800818	.	C	T	1	1	2	0	0	2	0	0
2	26846568	.	T	C	6	4	10	0	0	10	0	0
2	27153718	.	T	C	4	4	8	0	1	9	0	0
2	29961422	.	G	A	26	8	34	1	17	52	0	0
2	30174243	.	A	T	2	2	4	0	0	4	0	0
2	32173838	.	T	C	5	2	7	0	0	7	0	0
2	32196762	.	A	G	39	10	49	0	0	49	0	0
2	34746778	.	T	C	0	1	1	0	0	1	0	0
2	35089992	.	C	A	3	1	4	0	0	4	0	0
2	38614426	.	T	C	8	2	10	0	0	10	0	0
2	38903117	.	T	C	2	0	2	0	0	2	0	0
2	55003035	.	T	G	5	2	7	0	0	7	0	0
2	55005781	.	C	T	9	3	12	0	3	15	0	0
2	55005783	.	G	T	9	3	12	0	3	15	0	0
2	55327067	.	A	C	24	6	30	0	5	35	0	0
2	55327073	.	A	C	21	9	30	0	2	32	0	0
2	58162155	.	G	A	9	2	11	0	0	11	0	0
2	80668540	.	G	A	0	2	2	1	0	3	0	0
2	83711742	.	C	A	55	23	78	0	9	87	0	0
2	90263321	.	G	A	3	2	5	0	8	13	0	0
2	90263322	.	C	A	3	3	6	0	8	14	0	0
2	91064732	.	T	C	7	7	14	0	0	14	0	0
2	91064743	.	T	C	7	5	12	0	0	12	0	0
2	91551466	.	A	G	3	2	5	0	0	5	0	0
2	92248119	.	C	T	0	1	1	0	1	2	0	0
2	104511101	.	T	C	21	4	25	0	0	25	0	0
2	104511117	.	T	C	21	10	31	0	1	32	0	0
2	118700746	.	A	G	0	5	5	0	0	5	0	0
2	121015462	.	A	G	0	2	2	0	0	2	0	0
2	121373743	.	A	G	6	2	8	0	0	8	0	0
2	121374790	.	A	G	1	3	4	0	0	4	0	0
2	121374794	.	A	G	1	3	4	0	0	4	0	0
2	126733408	.	T	C	12	6	18	0	0	18	0	0
2	126734766	.	T	C	2	4	6	0	0	6	0	0
2	126734785	.	T	C	5	5	10	0	0	10	0	0
2	126734836	.	T	C	11	3	14	0	0	14	0	0
2	126734839	.	T	C	12	3	15	0	0	15	0	0
2	127132091	.	A	G	0	2	2	0	0	2	0	0
2	130396840	.	A	G	4	7	11	0	1	12	0	0
2	130396854	.	A	G	10	3	13	0	0	13	0	0
2	130410050	.	A	G	4	2	6	0	0	6	0	0
2	131141887	.	A	C	2	1	3	0	4	7	0	0
2	131141893	.	A	C	2	3	5	0	0	5	0	0
2	132151800	.	A	G	44	258	302	0	4	306	0	0
2	132708129	.	A	T	6	7	13	0	3	16	0	0
2	132708131	.	G	T	5	6	11	0	5	16	0	0
2	151548577	.	T	C	11	2	13	0	0	13	0	0
2	152114942	.	A	G	1	7	8	0	0	8	0	0
2	153051040	.	C	A	3	2	5	0	19	32	8	0
2	153459226	.	T	C	0	2	2	0	0	2	0	0
2	153459246	.	T	C	1	2	3	0	0	3	0	0
2	154379850	.	A	G	32	12	44	0	0	44	0	0
2	157238417	.	T	G	9	2	11	0	5	16	0	0
2	157238426	.	A	G	6	2	8	0	8	16	0	0
2	157400030	.	T	C	54	16	70	0	3	73	0	0
2	157400060	.	T	C	52	21	73	0	0	74	1	0
2	157400069	.	T	C	40	33	73	0	0	73	0	0
2	158220838	.	A	G	9	2	11	0	2	13	0	0
2	158225545	.	A	G	316	65	381	0	1	382	0	0
2	158226873	.	A	G	73	412	485	0	9	494	0	0
2	163309459	.	T	C	9	10	19	0	1	20	0	0
2	164635687	.	T	C	6	3	9	0	0	9	0	0
2	164953773	.	T	C	42	9	51	0	0	51	0	0
2	166937902	.	A	G	8	3	11	0	0	12	1	0
2	167317466	.	A	G	35	6	41	0	1	42	0	0
2	168055230	.	T	C	5	2	7	0	0	7	0	0
2	169913421	.	A	G	2	2	4	0	0	4	0	0
2	174169694	.	A	G	44	12	56	0	1	57	0	0
2	180323424	.	A	G	5	2	7	0	0	7	0	0
2	181229344	.	T	C	1	2	3	0	0	3	0	0
2	181510490	.	A	G	35	8	43	0	1	44	0	0
3	5625596	.	A	G	6	4	10	0	0	10	0	0
3	32636549	.	T	C	12	3	15	0	0	15	0	0
3	35862204	.	A	G	3	6	9	0	0	9	0	0
3	35862205	.	A	G	3	6	9	0	0	9	0	0
3	36223563	.	G	A	5	2	7	0	0	7	0	0
3	40748383	.	G	A	8	4	12	0	4	16	0	0
3	40748697	.	A	G	29	5	34	0	1	35	0	0
3	57551841	.	T	C	2	5	7	0	1	8	0	0
3	57551908	.	T	C	3	3	6	0	0	6	0	0
3	63928340	.	C	T	15	4	19	0	5	24	0	0
3	63928342	.	C	T	14	2	16	0	8	24	0	0
3	65866428	.	A	G	3	3	6	0	1	7	0	0
3	67385175	.	A	G	2	4	6	0	0	6	0	0
3	80599593	.	T	C	8	59	67	1	0	68	0	0
3	80614159	.	T	C	11	10	21	0	0	21	0	0
3	80614215	.	T	C	89	60	149	0	3	152	0	0
3	88259488	.	A	G	3	3	6	0	0	6	0	0
3	88259907	.	A	G	1	5	6	0	0	6	0	0
3	88712739	.	T	C	17	7	24	0	0	24	0	0
3	89675221	.	T	C	8	2	10	0	0	10	0	0
3	89967705	.	A	G	1	6	7	0	0	7	0	0
3	89967924	.	A	G	2	5	7	0	0	7	0	0
3	90270461	.	C	T	0	2	2	0	1	3	0	0
3	94794244	.	T	A	9	3	12	0	0	12	0	0
3	94794245	.	G	A	9	3	12	0	0	12	0	0
3	95090872	.	T	C	5	4	9	0	0	9	0	0
3	95090893	.	T	C	5	2	7	0	0	7	0	0
3	95094827	.	T	C	7	2	9	0	1	10	0	0
3	95230844	.	A	G	5	2	7	0	0	7	0	0
3	95668177	.	T	C	8	2	10	0	0	10	0	0
3	96539776	.	A	G	4	25	29	0	3	32	0	0
3	101483698	.	G	C	10	16	26	0	18	44	0	0
3	101483703	.	G	C	27	7	34	0	15	49	0	0
3	101766326	.	A	T	3	1	4	0	0	4	0	0
3	102973406	.	A	G	32	6	38	0	0	38	0	0
3	103698465	.	T	C	7	2	9	0	0	9	0	0
3	108463972	.	T	A	10	5	15	0	6	21	0	0
3	116537808	.	T	C	14	4	18	0	0	18	0	0
3	135112631	.	T	C	33	7	40	0	0	40	0	0
3	138265030	.	A	G	11	2	13	0	0	13	0	0
3	158267475	.	A	G	7	3	10	0	0	10	0	0
4	8145098	.	A	G	8	2	10	0	0	10	0	0
4	21834782	.	A	G	7	11	18	0	0	18	0	0
4	21834791	.	A	G	3	12	15	0	0	15	0	0
4	21869696	.	G	T	3	5	8	0	4	12	0	0
4	21869698	.	C	T	3	1	4	0	8	12	0	0
4	21911309	.	A	G	13	5	18	0	0	18	0	0
4	21911667	.	A	G	2	6	8	0	0	8	0	0
4	21911675	.	A	G	6	3	9	0	0	9	0	0
4	21911886	.	A	G	5	2	7	0	0	7	0	0
4	32022582	.	A	G	27	6	33	0	1	34	0	0
4	32645055	.	T	C	2	2	4	0	0	4	0	0
4	33019420	.	A	G	59	24	83	0	1	84	0	0
4	33020417	.	A	G	60	67	127	0	1	128	0	0
4	41025845	.	A	G	4	2	6	0	0	6	0	0
4	41518514	.	T	C	167	27	194	0	3	197	0	0
4	44994051	.	A	G	5	2	7	0	0	7	0	0
4	45377141	.	A	G	7	3	10	0	0	10	0	0
4	45377142	.	A	G	6	4	10	0	0	10	0	0
4	56811245	.	T	C	9	2	11	0	0	11	0	0
4	56870174	.	T	C	8	5	13	0	1	14	0	0
4	56870270	.	T	C	9	3	12	0	1	13	0	0
4	69844043	.	C	T	0	1	1	9	0	10	0	0
4	72120345	.	G	A	3	2	5	0	0	5	0	0
4	86495344	.	G	T	57	20	77	0	1	79	1	0
4	103021909	.	A	G	15	3	18	0	2	20	0	0
4	115992008	.	T	C	18	3	21	0	1	22	0	0
4	116410052	.	T	C	14	3	17	0	0	17	0	0
4	118483276	.	A	G	12	5	17	0	0	17	0	0
4	118484005	.	A	G	12	17	29	0	0	29	0	0
4	118484020	.	A	G	23	7	30	0	0	30	0	0
4	118484072	.	A	G	16	6	22	0	1	23	0	0
4	119080668	.	T	C	8	2	10	0	0	10	0	0
4	119135361	.	C	T	21	15	36	0	16	52	0	0
4	120918082	.	A	G	11	3	14	0	1	15	0	0
4	124838094	.	A	G	6	9	15	0	0	15	0	0
4	124838169	.	A	G	14	5	19	0	0	19	0	0
4	125982774	.	A	G	8	2	10	0	1	11	0	0
4	125982944	.	A	G	12	8	20	0	0	20	0	0
4	125985065	.	A	G	4	5	9	0	0	9	0	0
4	125985078	.	A	G	4	4	8	0	0	8	0	0
4	125985370	.	A	G	4	4	8	0	0	8	0	0
4	125985396	.	A	G	5	2	7	0	1	8	0	0
4	126929461	.	G	T	16	7	23	0	0	23	0	0
4	128601753	.	G	T	3	0	3	0	0	3	0	0
4	128601755	.	A	T	3	0	3	0	0	3	0	0
4	129116662	.	T	A	13	1	14	0	0	14	0	0
4	129116665	.	A	T	13	1	14	0	0	14	0	0
4	136379286	.	T	C	1	2	3	0	0	3	0	0
4	136379306	.	T	C	2	2	4	0	0	4	0	0
4	137384425	.	A	T	16	7	23	0	7	30	0	0
4	137934374	.	T	A	3	3	6	0	0	6	0	0
4	137987354	.	A	G	64	22	86	0	0	86	0	0
4	138184300	.	A	G	2	4	6	0	0	6	0	0
4	138184311	.	T	A	1	2	3	0	2	5	0	0
4	140678893	.	A	G	7	4	11	1	0	12	0	0
4	147909430	.	T	C	2	3	5	0	0	5	0	0
4	149202586	.	A	G	20	7	27	0	1	28	0	0
4	149202605	.	A	G	22	6	28	0	0	28	0	0
4	149203211	.	A	G	17	7	24	0	0	24	0	0
4	149552656	.	T	C	5	3	8	0	0	8	0	0
4	149552691	.	T	C	6	3	9	0	0	9	0	0
4	155705483	.	A	G	31	6	37	0	0	37	0	0
4	155705891	.	A	G	0	3	3	0	1	4	0	0
4	155705922	.	A	G	1	3	4	0	0	4	0	0
4	156095123	.	A	G	62	37	99	0	5	104	0	0
4	156105693	.	T	C	3	4	7	0	0	7	0	0
4	156105697	.	T	C	5	2	7	0	0	7	0	0
4	156249762	.	A	G	3	2	5	0	0	5	0	0
5	3653247	.	G	C	4	0	4	0	0	4	0	0
5	3680495	.	T	C	2	2	4	0	0	4	0	0
5	3680498	.	T	C	2	2	4	0	0	4	0	0
5	5833142	.	A	G	0	1	1	1	5	7	0	0
5	5833442	.	T	C	0	4	4	2	0	6	0	0
5	24649635	.	T	C	28	6	34	0	2	36	0	0
5	25430779	.	A	G	4	3	7	0	0	7	0	0
5	29658124	.	A	G	8	2	10	0	0	10	0	0
5	29658129	.	A	G	2	8	10	0	0	10	0	0
5	31330824	.	T	C	3	3	6	0	0	6	0	0
5	33149755	.	A	G	10	3	13	0	0	13	0	0
5	33572751	.	A	G	1	3	4	0	0	4	0	0
5	33573262	.	A	G	1	3	4	0	1	5	0	0
5	33573281	.	A	G	2	5	7	0	0	7	0	0
5	33573900	.	A	G	1	2	3	0	0	3	0	0
5	33575654	.	A	G	3	3	6	0	0	6	0	0
5	33575673	.	A	G	3	2	5	0	0	5	0	0
5	33575750	.	A	G	2	2	4	0	0	4	0	0
5	34333308	.	C	T	11	3	14	0	3	17	0	0
5	36157689	.	C	T	5	4	9	0	0	9	0	0
5	48464270	.	T	A	4	5	9	0	0	9	0	0
5	64960686	.	A	G	1	2	3	0	0	3	0	0
5	65605388	.	T	C	44	19	63	0	0	63	0	0
5	65605389	.	T	C	29	28	57	0	6	63	0	0
5	73450654	.	C	T	3	2	5	0	0	5	0	0
5	73469787	.	A	G	48	13	61	0	0	62	1	0
5	77555578	.	T	C	5	11	16	0	0	16	0	0
5	81168091	.	T	A	3	0	3	0	7	10	0	0
5	81168532	.	G	A	1	2	3	0	0	3	0	0
5	96930391	.	G	T	9	3	12	0	1	13	0	0
5	104652843	.	A	G	21	6	27	0	0	27	0	0
5	108256092	.	C	T	8	3	11	0	2	13	0	0
5	110226907	.	G	A	1	2	3	0	0	3	0	0
5	110413206	.	T	C	4	3	7	0	0	7	0	0
5	114078736	.	T	C	10	2	12	0	0	12	0	0
5	115436895	.	A	G	3	2	5	0	0	5	0	0
5	115437904	.	T	C	1	2	3	0	0	3	0	0
5	117378654	.	A	C	4	2	6	0	0	6	0	0
5	121683511	.	T	C	9	3	12	0	0	12	0	0
5	121824675	.	C	T	3	2	5	0	4	9	0	0
5	122303913	.	A	G	2	2	4	0	0	4	0	0
5	122546590	.	A	G	12	2	14	0	0	14	0	0
5	122547685	.	A	G	8	2	10	0	1	11	0	0
5	122872763	.	T	C	12	3	15	0	1	16	0	0
5	123386729	.	A	G	16	5	21	0	0	21	0	0
5	123510674	.	G	T	5	3	8	0	0	8	0	0
5	123879315	.	T	C	4	4	8	0	0	8	0	0
5	123879350	.	T	C	5	3	8	0	0	8	0	0
5	123880012	.	G	T	0	1	1	0	0	1	0	0
5	123880013	.	G	T	0	1	1	0	0	1	0	0
5	123880062	.	T	C	1	2	3	0	0	3	0	0
5	124065671	.	C	T	3	2	5	0	2	7	0	0
5	124065673	.	C	T	3	2	5	0	2	7	0	0
5	125533669	.	A	G	24	50	74	0	1	75	0	0
5	125533970	.	A	G	35	8	43	0	1	44	0	0
5	125534541	.	A	G	60	26	86	0	0	86	0	0
5	129795821	.	A	G	8	6	14	0	0	14	0	0
5	129797823	.	A	G	4	10	14	0	1	15	0	0
5	129798517	.	A	G	19	4	23	0	0	23	0	0
5	130162859	.	A	G	0	2	2	0	0	2	0	0
5	134173078	.	G	A	4	9	13	0	6	19	0	0
5	135193845	.	A	G	3	2	5	0	0	5	0	0
5	135437709	.	T	C	14	10	24	0	0	24	0	0
5	135437715	.	T	C	18	7	25	0	0	25	0	0
5	136941953	.	A	G	69	26	95	0	2	97	0	0
5	137336162	.	T	C	5	3	8	0	0	8	0	0
5	137336165	.	T	C	3	3	6	0	2	8	0	0
5	140606797	.	C	G	12	8	20	0	11	31	0	0
5	140606802	.	T	G	16	8	24	0	11	35	0	0
5	142655047	.	A	G	84	21	105	0	1	106	0	0
5	142855997	.	T	C	2	3	5	0	1	6	0	0
5	142856760	.	T	C	16	5	21	0	0	21	0	0
5	142873873	.	T	C	4	2	6	0	0	6	0	0
5	142888875	.	G	T	8	7	15	0	0	15	0	0
5	143751066	.	A	G	10	6	16	0	0	16	0	0
5	145045567	.	C	A	2	4	6	0	0	6	0	0
6	4758554	.	C	T	12	3	15	0	0	15	0	0
6	31489086	.	A	G	6	18	24	0	1	25	0	0
6	31489220	.	A	G	2	2	4	0	0	4	0	0
6	31492602	.	A	G	8	8	16	0	0	16	0	0
6	31492665	.	A	G	9	4	13	0	0	13	0	0
6	31492682	.	A	G	7	5	12	0	0	12	0	0
6	31492702	.	A	G	7	2	9	0	0	9	0	0
6	32121496	.	C	T	3	3	6	0	0	6	0	0
6	37783131	.	C	T	0	2	2	4	0	6	0	0
6	39312088	.	T	C	12	7	19	0	0	19	0	0
6	39312096	.	T	C	16	6	22	0	1	23	0	0
6	47846393	.	A	G	10	5	15	0	0	15	0	0
6	47846415	.	A	G	10	5	15	0	0	15	0	0
6	47848284	.	A	G	5	2	7	0	0	7	0	0
6	47848294	.	A	G	8	2	10	0	0	10	0	0
6	47848659	.	A	G	2	6	8	0	0	8	0	0
6	47848676	.	A	G	4	2	6	0	0	6	0	0
6	47849226	.	A	G	4	4	8	0	0	8	0	0
6	48375235	.	A	G	3	4	7	0	0	7	0	0
6	49231811	.	T	C	12	3	15	0	0	15	0	0
6	49231812	.	T	C	10	5	15	0	0	15	0	0
6	57994501	.	T	A	2	0	2	4	1	7	0	0
6	66517065	.	A	G	3	2	5	0	0	5	0	0
6	66517110	.	A	G	4	4	8	0	0	8	0	0
6	66517162	.	A	G	1	2	3	0	0	3	0	0
6	66517625	.	A	G	3	13	16	0	0	16	0	0
6	66517635	.	A	G	15	4	19	0	0	19	0	0
6	66517775	.	A	G	8	4	12	0	0	12	0	0
6	71791046	.	T	C	4	2	6	0	0	6	0	0
6	77577393	.	T	C	1	2	3	0	0	3	0	0
6	85311954	.	A	C	2	2	4	0	0	5	1	0
6	85932353	.	T	C	13	4	17	0	2	19	0	0
6	86393034	.	A	G	0	3	3	0	0	3	0	0
6	86393045	.	A	G	3	2	5	0	0	5	0	0
6	87795142	.	T	C	11	2	13	0	0	13	0	0
6	91732491	.	G	A	19	26	45	0	5	50	0	0
6	96010078	.	C	T	0	3	3	1	1	5	0	0
6	115903513	.	G	A	9	5	14	0	1	15	0	0
6	118570609	.	T	G	13	4	17	0	7	24	0	0
6	119458691	.	A	G	6	2	8	0	0	8	0	0
6	122716311	.	T	C	3	2	5	0	0	5	0	0
6	124787015	.	A	G	0	6	6	0	1	7	0	0
6	124787022	.	T	G	1	6	7	0	0	7	0	0
6	125171660	.	A	G	5	2	7	0	0	7	0	0
6	125338469	.	T	C	7	1	8	0	0	8	0	0
6	126619121	.	T	C	48	34	82	0	0	82	0	0
6	141445932	.	T	C	4	2	6	0	0	6	0	0
6	143774299	.	C	T	7	2	9	0	2	11	0	0
6	146012954	.	C	T	1	1	2	0	1	3	0	0
6	146364991	.	G	A	1	3	4	1	0	5	0	0
6	149236614	.	A	G	2	2	4	0	1	5	0	0
6	149236615	.	A	G	3	2	5	0	0	5	0	0
6	149236756	.	A	G	7	2	9	0	0	9	0	0
7	3386270	.	A	G	7	2	9	0	0	9	0	0
7	3463600	.	A	G	83	20	103	0	1	104	0	0
7	4139210	.	A	G	8	2	10	0	0	10	0	0
7	4429824	.	G	A	0	1	1	0	3	4	0	0
7	4429826	.	T	A	0	2	2	0	2	4	0	0
7	4796292	.	A	C	8	3	11	0	4	15	0	0
7	6357880	.	A	G	2	2	4	0	0	4	0	0
7	6967965	.	A	G	7	4	11	0	0	11	0	0
7	6968013	.	A	G	6	5	11	0	0	11	0	0
7	6969259	.	A	G	18	3	21	0	2	23	0	0
7	6969451	.	A	G	11	5	16	0	1	17	0	0
7	6969462	.	A	G	17	4	21	0	0	21	0	0
7	6969513	.	A	G	6	13	19	0	0	19	0	0
7	6969543	.	A	G	17	4	21	0	0	21	0	0
7	12601882	.	T	C	1	2	3	0	0	3	0	0
7	12706119	.	A	G	5	2	7	0	1	8	0	0
7	12706157	.	A	G	4	2	6	0	1	7	0	0
7	16606020	.	T	C	6	3	9	0	0	9	0	0
7	16619450	.	A	G	20	4	24	0	0	24	0	0
7	16619714	.	A	G	69	15	84	0	1	85	0	0
7	18873686	.	T	C	15	3	18	0	0	18	0	0
7	18873733	.	T	C	4	2	6	0	0	6	0	0
7	18873753	.	T	C	7	2	9	0	0	9	0	0
7	19240036	.	T	C	7	2	9	0	0	9	0	0
7	19366262	.	T	A	5	2	7	0	0	7	0	0
7	19638449	.	T	A	1	4	5	0	0	5	0	0
7	19638461	.	T	A	1	2	3	0	0	3	0	0
7	23840662	.	G	A	0	4	4	6	0	10	0	0
7	23840986	.	C	A	11	4	15	1	0	16	0	0
7	23933876	.	G	A	0	1	1	0	0	1	0	0
7	23974523	.	T	A	1	8	9	0	0	9	0	0
7	24710068	.	T	C	61	12	73	0	0	73	0	0
7	24710075	.	T	C	56	13	69	0	2	71	0	0
7	24925776	.	C	T	0	12	12	0	1	13	0	0
7	25370997	.	A	G	4	2	6	0	0	6	0	0
7	26904993	.	A	G	2	5	7	0	0	7	0	0
7	26905060	.	A	G	4	3	7	0	0	7	0	0
7	27227593	.	T	C	85	18	103	0	3	106	0	0
7	27520956	.	A	G	1	3	4	0	0	4	0	0
7	28922269	.	T	C	3	1	4	0	0	4	0	0
7	28922288	.	T	C	7	3	10	0	0	10	0	0
7	28922504	.	T	C	4	3	7	0	0	7	0	0
7	28922548	.	T	C	3	2	5	0	0	5	0	0
7	29880102	.	A	G	15	3	18	0	1	19	0	0
7	39218901	.	A	G	10	4	14	0	0	14	0	0
7	44629089	.	T	C	5	3	8	0	0	8	0	0
7	45032973	.	T	C	7	5	12	0	1	13	0	0
7	45140801	.	T	C	1	3	4	0	0	4	0	0
7	55627368	.	T	C	61	21	82	0	1	83	0	0
7	58899042	.	T	C	5	3	8	0	0	8	0	0
7	61589842	.	T	C	4	2	6	0	0	6	0	0
7	73387821	.	T	C	3	2	5	0	0	5	0	0
7	75373547	.	G	A	1	0	1	0	0	1	0	0
7	81180363	.	A	G	3	3	6	0	0	6	0	0
7	81521958	.	A	G	1	2	3	0	0	3	0	0
7	83274886	.	T	C	9	4	13	0	0	13	0	0
7	92490504	.	T	C	10	2	12	0	1	13	0	0
7	103988513	.	T	C	2	4	6	0	0	6	0	0
7	109584744	.	T	C	2	2	4	0	0	4	0	0
7	110655309	.	T	C	18	7	25	1	2	28	0	0
7	121586870	.	T	C	1	1	2	0	0	2	0	0
7	126853494	.	A	G	34	6	40	0	1	41	0	0
7	126853784	.	A	G	38	7	45	0	1	46	0	0
7	127178234	.	A	G	1	4	5	0	0	5	0	0
7	127519115	.	A	G	1	3	4	0	0	4	0	0
7	127582705	.	A	G	2	2	4	0	0	4	0	0
7	130360893	.	A	T	2	6	8	0	0	8	0	0
7	139685712	.	T	C	17	6	23	0	0	23	0	0
7	139715688	.	A	G	2	3	5	0	0	5	0	0
7	139716479	.	A	G	1	2	3	0	0	3	0	0
7	139730542	.	T	C	1	0	1	0	0	1	0	0
7	140390965	.	T	C	16	4	20	0	1	21	0	0
7	140391011	.	T	C	12	2	14	0	0	14	0	0
7	140391023	.	T	C	5	6	11	0	1	12	0	0
7	141014245	.	G	A	4	0	4	0	0	4	0	0
7	141503659	.	T	C	13	4	17	0	0	17	0	0
7	141503671	.	G	C	12	0	12	0	0	12	0	0
7	141909252	.	A	G	3	2	5	0	0	5	0	0
7	142207010	.	T	C	24	13	37	0	1	38	0	0
8	3588384	.	A	G	4	4	8	0	0	8	0	0
8	3588399	.	A	G	1	5	6	0	0	6	0	0
8	12911633	.	C	T	8	5	13	0	0	13	0	0
8	13336085	.	T	C	3	2	5	0	0	5	0	0
8	19732474	.	C	A	6	3	9	0	0	9	0	0
8	19737779	.	A	G	1	1	2	0	1	3	0	0
8	19737782	.	C	G	2	1	3	0	0	3	0	0
8	19741629	.	C	T	0	1	1	0	0	1	0	0
8	20030704	.	C	T	19	3	22	3	0	25	0	0
8	20030723	.	G	T	12	2	14	0	0	14	0	0
8	20030855	.	G	A	4	3	7	0	0	7	0	0
8	20717388	.	G	A	0	1	1	0	0	1	0	0
8	20727130	.	G	A	24	12	36	0	0	36	0	0
8	20727188	.	A	G	4	2	6	0	0	6	0	0
8	20727193	.	A	G	5	1	6	0	0	6	0	0
8	26070224	.	T	C	2	2	4	0	0	4	0	0
8	37404771	.	C	T	3	0	3	0	1	4	0	0
8	39618334	.	C	A	16	6	22	0	0	22	0	0
8	42700052	.	A	G	0	4	4	2	0	6	0	0
8	59366732	.	C	T	4	4	8	0	0	8	0	0
8	59366734	.	C	T	4	3	7	0	1	8	0	0
8	61848427	.	G	T	10	4	14	0	3	17	0	0
8	69766592	.	A	G	17	3	20	0	0	20	0	0
8	70017218	.	C	G	1	2	3	0	0	4	1	0
8	70017392	.	A	T	1	2	3	1	0	4	0	0
8	70023362	.	T	G	1	1	2	0	0	2	0	0
8	70028756	.	G	A	0	0	0	0	1	1	0	0
8	70028770	.	G	A	2	3	5	0	0	5	0	0
8	70037701	.	A	T	1	2	3	0	0	3	0	0
8	70037710	.	A	C	1	2	3	0	0	3	0	0
8	70273645	.	G	A	3	2	5	0	0	5	0	0
8	72977426	.	A	G	13	25	38	0	0	38	0	0
8	73236514	.	T	C	55	10	65	0	2	67	0	0
8	83590231	.	A	C	6	1	7	0	2	9	0	0
8	84723069	.	T	A	7	3	10	0	2	12	0	0
8	85835300	.	T	C	1	3	4	0	0	4	0	0
8	94743331	.	T	C	4	2	6	0	1	7	0	0
8	94743940	.	T	C	2	3	5	0	1	6	0	0
8	106657183	.	T	C	4	2	6	0	0	6	0	0
8	107299930	.	C	T	0	2	2	2	0	4	0	0
8	107744427	.	A	G	5	6	11	0	0	11	0	0
8	110817217	.	A	G	29	7	36	0	2	38	0	0
8	111731406	.	T	C	24	4	28	0	0	28	0	0
8	111731423	.	T	C	21	3	24	0	1	25	0	0
8	111731758	.	T	C	24	9	33	0	0	33	0	0
8	121822968	.	A	G	5	1	6	0	2	8	0	0
8	123087128	.	A	G	4	2	6	0	0	6	0	0
8	124261954	.	A	G	10	2	12	0	0	12	0	0
8	125620618	.	T	C	12	9	21	0	2	23	0	0
8	125620861	.	T	C	20	9	29	0	0	29	0	0
8	125620929	.	T	C	12	14	26	0	0	26	0	0
8	126865747	.	A	G	4	2	6	0	0	6	0	0
9	3387716	.	A	G	7	2	9	0	0	9	0	0
9	3387771	.	A	G	15	3	18	0	0	18	0	0
9	4313759	.	A	G	2	1	3	0	1	4	0	0
9	4456006	.	T	C	0	2	2	0	0	2	0	0
9	20512857	.	A	G	3	2	5	0	0	5	0	0
9	20512895	.	A	G	1	1	2	0	0	2	0	0
9	20512914	.	A	G	2	0	2	0	0	2	0	0
9	27260291	.	G	T	1	3	4	0	0	4	0	0
9	40124155	.	C	T	3	1	4	0	0	4	0	0
9	40181176	.	G	T	5	1	6	0	0	6	0	0
9	42163217	.	T	G	15	6	21	0	2	23	0	0
9	44206375	.	T	C	8	2	10	0	0	10	0	0
9	44322503	.	T	C	6	3	9	0	1	10	0	0
9	49415404	.	G	A	2	2	4	0	5	9	0	0
9	49415411	.	G	A	3	1	4	0	5	9	0	0
9	50846404	.	A	G	1	1	2	0	1	3	0	0
9	53350462	.	C	T	2	2	4	0	1	5	0	0
9	53350464	.	C	T	2	2	4	0	1	5	0	0
9	54854496	.	A	G	2	3	5	0	0	5	0	0
9	57503030	.	C	T	15	4	19	0	1	20	0	0
9	65253476	.	A	G	5	2	7	0	0	7	0	0
9	66936546	.	G	A	7	2	9	0	0	9	0	0
9	67892060	.	C	T	5	5	10	0	1	11	0	0
9	69923101	.	A	G	5	1	6	0	0	6	0	0
9	69923122	.	A	G	5	1	6	0	0	6	0	0
9	72270786	.	C	A	11	4	15	0	9	24	0	0
9	72369081	.	T	C	1	2	3	0	0	3	0	0
9	72381418	.	T	C	1	3	4	0	0	4	0	0
9	75128602	.	T	A	27	42	69	0	3	72	0	0
9	89794102	.	T	C	10	1	11	0	7	18	0	0
9	89794108	.	G	C	9	3	12	0	4	16	0	0
9	95439470	.	T	C	0	2	2	0	0	2	0	0
9	95448061	.	C	T	6	5	11	0	3	14	0	0
9	95448949	.	G	A	12	3	15	0	5	20	0	0
9	95748061	.	T	C	2	2	4	0	0	4	0	0
9	95938187	.	A	G	2	3	5	0	0	5	0	0
9	95938188	.	A	G	3	2	5	0	0	5	0	0
9	96204017	.	G	A	8	4	12	0	0	12	0	0
9	106117115	.	T	C	1	2	3	0	0	3	0	0
9	106251564	.	C	T	49	13	62	0	3	65	0	0
9	116406522	.	C	T	5	1	6	0	0	6	0	0
9	118754231	.	C	G	3	2	5	0	0	5	0	0
9	121510177	.	G	A	2	5	7	0	0	7	0	0
9	122677417	.	T	C	3	2	5	0	0	5	0	0
9	124034094	.	A	G	8	1	9	0	0	9	0	0
X	7774376	.	A	G	3	3	6	0	0	6	0	0
X	8005987	.	T	C	7	2	9	0	0	9	0	0
X	40743165	.	A	G	6	6	12	0	0	12	0	0
X	55695874	.	A	G	2	4	6	0	0	6	0	0
X	55695894	.	A	G	2	6	8	0	0	8	0	0
X	60163414	.	G	C	2	2	4	0	1	5	0	0
X	60226851	.	T	C	15	7	22	0	0	22	0	0
X	60231705	.	A	G	17	14	31	0	0	31	0	0
X	69388211	.	G	A	23	3	26	1	6	33	0	0
X	72774989	.	A	G	1	3	4	0	0	4	0	0
X	73270255	.	T	C	4	7	11	0	0	11	0	0
X	73270468	.	T	C	3	11	14	0	1	15	0	0
X	73328516	.	A	G	3	1	4	0	0	4	0	0
X	73328537	.	A	G	3	2	5	0	0	5	0	0
X	73329113	.	A	G	7	5	12	0	0	12	0	0
X	73329453	.	A	G	4	2	6	0	0	6	0	0
X	85784674	.	A	G	3	2	5	0	0	5	0	0
X	93318384	.	A	T	1	2	3	0	0	3	0	0
X	93318385	.	G	T	1	2	3	0	0	3	0	0
X	98509358	.	A	T	1	2	3	0	0	3	0	0
X	102620158	.	T	C	8	16	24	0	0	24	0	0
X	102620159	.	T	C	5	17	22	0	2	24	0	0
X	102621879	.	A	G	7	2	9	0	0	9	0	0
X	102623385	.	T	C	12	6	18	0	0	18	0	0
X	102625158	.	T	C	4	2	6	0	0	6	0	0
X	102631446	.	T	C	0	3	3	0	0	3	0	0
X	102631452	.	T	C	2	2	4	0	1	5	0	0
X	103122015	.	A	G	7	2	9	0	0	9	0	0
X	103125399	.	A	G	8	3	11	0	0	12	1	0
X	106830700	.	T	C	37	9	46	0	0	46	0	0
X	111951143	.	C	T	12	5	17	0	7	24	0	0
X	111951145	.	G	T	13	2	15	0	9	24	0	0
X	133489379	.	T	C	1	6	7	0	1	8	0	0
X	133489839	.	T	C	9	3	12	0	0	12	0	0
X	133490101	.	T	C	9	3	12	0	0	12	0	0
X	133490145	.	T	C	5	2	7	0	0	7	0	0
X	138845692	.	G	A	5	2	7	0	0	7	0	0
X	141617410	.	G	T	11	3	14	0	0	14	0	0
X	149766871	.	T	C	19	12	31	1	3	35	0	0
X	149767614	.	T	C	44	69	113	2	2	117	0	0
X	149768450	.	T	C	117	37	154	0	0	154	0	0
X	149768451	.	T	C	109	42	151	0	3	154	0	0
X	161815241	.	A	G	9	2	11	0	0	11	0	0
X	164972992	.	A	G	4	2	6	0	0	6	0	0
