contig	position	variantID	refAllele	altAllele	refCount	altCount	totalCount	lowMAPQDepth	lowBaseQDepth	rawDepth	otherBases	improperPairs
1	9792783	.	T	C	24	5	29	0	1	30	0	0
1	11168780	.	C	T	8	2	10	0	1	11	0	0
1	11667225	.	A	G	33	7	40	0	1	41	0	0
1	13636292	.	T	A	6	2	8	0	12	20	0	0
1	13695233	.	T	C	8	5	13	0	0	13	0	0
1	13695239	.	T	C	10	5	15	0	0	15	0	0
1	13695990	.	A	G	5	2	7	0	1	8	0	0
1	16717060	.	T	C	6	1	7	0	1	8	0	0
1	16717105	.	T	C	3	2	5	0	0	5	0	0
1	22031785	.	T	C	1	7	8	0	0	8	0	0
1	34763590	.	G	C	10	2	12	0	0	12	0	0
1	36546044	.	T	A	8	2	10	0	0	10	0	0
1	39695898	.	A	G	2	3	5	0	0	5	0	0
1	51507738	.	T	C	1	3	4	0	0	4	0	0
1	52224672	.	G	A	5	4	9	0	0	9	0	0
1	59913367	.	A	G	45	22	67	0	1	68	0	0
1	60517747	.	A	G	19	34	53	0	14	67	0	0
1	62855794	.	T	C	8	3	11	0	0	11	0	0
1	63156443	.	A	G	4	2	6	0	1	7	0	0
1	66711873	.	A	G	54	35	89	0	7	96	0	0
1	68071399	.	A	G	5	4	9	0	0	9	0	0
1	75398702	.	A	G	18	3	21	0	0	21	0	0
1	75398708	.	A	G	2	19	21	0	0	21	0	0
1	86273633	.	T	C	14	6	20	0	0	20	0	0
1	86273638	.	T	C	11	6	17	0	0	17	0	0
1	86275426	.	G	T	6	3	9	0	0	9	0	0
1	86836917	.	T	C	0	2	2	10	0	12	0	0
1	88188916	.	C	A	2	2	4	0	0	4	0	0
1	88189462	.	G	A	2	2	4	0	0	4	0	0
1	88189563	.	C	T	2	2	4	0	1	5	0	0
1	88189685	.	C	A	3	2	5	0	0	5	0	0
1	88189797	.	G	A	2	2	4	0	0	4	0	0
1	88189889	.	C	T	1	2	3	0	0	3	0	0
1	88190921	.	C	T	0	9	9	0	0	9	0	0
1	88191237	.	A	C	17	34	51	0	3	54	0	0
1	88191320	.	C	T	6	34	40	0	0	40	0	0
1	88191706	.	G	A	28	10	38	0	1	39	0	0
1	88191710	.	T	C	16	21	37	0	1	38	0	0
1	88191744	.	C	A	40	9	49	0	2	51	0	0
1	88192008	.	C	T	42	12	54	0	8	62	0	0
1	88192048	.	G	C	7	34	41	0	2	43	0	0
1	88192098	.	G	A	48	8	56	0	1	57	0	0
1	88192180	.	G	T	47	8	55	0	0	55	0	0
1	88192184	.	T	A	45	8	53	0	0	53	0	0
1	88192243	.	A	G	10	41	51	0	1	52	0	0
1	88192700	.	G	A	10	39	49	0	0	49	0	0
1	88192756	.	G	A	10	28	38	0	1	39	0	0
1	88192980	.	A	G	1	46	47	0	3	50	0	0
1	88193031	.	C	G	2	20	22	0	0	22	0	0
1	88193194	.	C	T	0	5	5	0	0	5	0	0
1	88193568	.	A	C	2	2	4	0	0	4	0	0
1	88193702	.	T	G	1	12	13	0	0	13	0	0
1	88193917	.	G	A	13	18	31	0	0	31	0	0
1	88197053	.	T	C	0	2	2	0	0	2	0	0
1	88197991	.	A	G	6	17	23	0	0	23	0	0
1	88200605	.	C	A	1	8	9	0	0	9	0	0
1	88200670	.	G	A	2	12	14	0	0	14	0	0
1	88200771	.	G	A	12	4	16	0	1	17	0	0
1	88200832	.	C	T	5	12	17	0	0	17	0	0
1	88202772	.	A	T	1	0	1	0	0	1	0	0
1	88204960	.	T	C	2	6	8	1	0	9	0	0
1	91860479	.	C	T	7	2	9	0	1	10	0	0
1	91860480	.	G	T	7	2	9	0	1	10	0	0
1	93299301	.	A	G	15	3	18	0	0	18	0	0
1	93299307	.	A	G	15	5	20	0	0	20	0	0
1	93299362	.	A	G	3	4	7	0	0	7	0	0
1	118225697	.	T	C	3	2	5	0	0	5	0	0
1	123251187	.	T	C	1	2	3	0	0	3	0	0
1	130649455	.	T	C	2	2	4	0	0	4	0	0
1	131953439	.	T	C	16	8	24	0	0	24	0	0
1	131954455	.	T	C	4	2	6	0	0	6	0	0
1	133065748	.	A	G	30	6	36	0	0	36	0	0
1	143631499	.	T	C	21	3	24	0	0	24	0	0
1	156083182	.	C	T	2	1	3	0	0	3	0	0
1	156255182	.	T	C	6	9	15	0	0	15	0	0
1	156255601	.	T	C	5	3	8	0	0	8	0	0
1	156386591	.	G	A	5	2	7	0	3	10	0	0
1	165001989	.	A	C	5	2	7	0	0	7	0	0
1	171151897	.	T	C	1	2	3	0	0	3	0	0
1	180924020	.	T	C	36	13	49	0	1	50	0	0
1	180996273	.	A	C	6	5	11	0	6	17	0	0
1	180996279	.	A	C	6	6	12	0	4	16	0	0
1	183190594	.	A	G	10	7	17	0	0	17	0	0
1	189851936	.	G	T	8	1	9	0	1	10	0	0
1	189851941	.	G	T	7	2	9	0	1	10	0	0
10	3823228	.	C	T	8	2	10	0	1	11	0	0
10	7524278	.	T	C	1	2	3	0	0	3	0	0
10	9503824	.	G	A	7	2	9	0	1	10	0	0
10	14621524	.	C	T	1	0	1	0	0	1	0	0
10	14621525	.	C	T	1	0	1	0	0	1	0	0
10	20194372	.	A	G	1	4	5	0	0	5	0	0
10	29104018	.	G	T	5	4	9	0	0	9	0	0
10	29104019	.	G	T	5	3	8	0	1	9	0	0
10	29104115	.	A	G	16	4	20	0	1	21	0	0
10	33865196	.	T	C	4	1	5	0	1	6	0	0
10	33865220	.	T	C	6	0	6	0	0	6	0	0
10	33868473	.	T	C	10	5	15	0	0	15	0	0
10	33868474	.	T	C	8	6	14	0	1	15	0	0
10	39888519	.	A	G	1	1	2	0	1	3	0	0
10	41595792	.	T	C	4	1	5	0	0	5	0	0
10	42574864	.	A	G	1	2	3	0	0	3	0	0
10	45752162	.	G	A	2	3	5	0	0	5	0	0
10	48976124	.	C	A	3	2	5	0	1	6	0	0
10	48976129	.	C	A	2	0	2	0	4	6	0	0
10	49118584	.	T	C	10	11	21	0	0	21	0	0
10	49118640	.	T	C	6	4	10	0	0	10	0	0
10	49120426	.	T	C	0	14	14	0	1	15	0	0
10	49148885	.	T	C	3	22	25	0	0	25	0	0
10	57391874	.	C	T	10	4	14	0	0	14	0	0
10	77159865	.	T	C	10	2	12	0	0	12	0	0
10	82486613	.	T	C	23	6	29	0	0	29	0	0
10	82585207	.	G	A	35	8	43	0	5	48	0	0
10	86672208	.	A	G	17	17	34	0	3	37	0	0
10	88306039	.	T	C	17	5	22	0	2	24	0	0
10	88306343	.	T	C	5	2	7	0	1	8	0	0
10	88306344	.	T	C	5	3	8	0	0	8	0	0
10	93320644	.	G	T	5	1	6	0	0	6	0	0
10	93320645	.	A	G	5	1	6	0	0	6	0	0
10	94057224	.	A	G	9	5	14	0	0	14	0	0
10	112761338	.	C	T	3	3	6	0	0	6	0	0
10	116310329	.	G	T	9	2	11	0	1	12	0	0
10	122830349	.	A	C	6	2	8	0	0	8	0	0
10	126903751	.	T	C	37	16	53	0	0	53	0	0
10	127038297	.	T	C	5	2	7	0	0	7	0	0
10	127500403	.	C	G	7	2	9	0	0	9	0	0
11	3079179	.	C	T	3	2	5	10	0	15	0	0
11	3448459	.	T	C	8	2	10	0	0	10	0	0
11	4091383	.	T	C	11	4	15	0	1	16	0	0
11	4091432	.	T	C	13	5	18	0	0	18	0	0
11	4092790	.	T	C	16	7	23	0	0	23	0	0
11	4514133	.	G	A	0	2	2	0	0	2	0	0
11	5663916	.	C	T	5	2	7	0	0	7	0	0
11	20178606	.	T	C	5	3	8	0	0	8	0	0
11	23687729	.	C	A	3	1	4	0	0	4	0	0
11	23687730	.	A	G	3	1	4	0	0	4	0	0
11	30051758	.	T	C	7	2	9	0	0	9	0	0
11	30051812	.	T	C	8	3	11	0	0	11	0	0
11	43573028	.	A	G	3	3	6	0	0	6	0	0
11	43574343	.	A	G	1	1	2	0	1	3	0	0
11	46163470	.	T	C	42	209	251	0	3	254	0	0
11	54730814	.	T	C	14	2	16	0	0	16	0	0
11	57676692	.	G	T	5	1	6	0	1	7	0	0
11	57687191	.	T	C	1	0	1	0	0	1	0	0
11	59224097	.	A	T	8	2	10	0	0	10	0	0
11	59347027	.	A	G	16	13	29	0	1	30	0	0
11	59347029	.	A	G	17	12	29	0	1	30	0	0
11	59347092	.	A	G	20	5	25	0	2	27	0	0
11	59349201	.	A	G	16	4	20	0	0	20	0	0
11	59401821	.	A	G	17	3	20	0	0	20	0	0
11	59401881	.	A	G	4	4	8	0	0	8	0	0
11	62670115	.	T	C	7	2	9	0	0	9	0	0
11	67579383	.	C	G	6	3	9	0	25	35	1	0
11	69514179	.	A	G	5	2	7	0	1	8	0	0
11	69675231	.	A	G	2	3	5	0	0	5	0	0
11	69922901	.	A	G	1	2	3	0	0	3	0	0
11	69922910	.	A	G	0	1	1	0	0	1	0	0
11	69922950	.	A	G	1	2	3	0	0	3	0	0
11	69923921	.	A	G	3	3	6	1	1	8	0	0
11	69926812	.	A	G	1	3	4	0	1	5	0	0
11	69927869	.	A	G	4	6	10	0	0	10	0	0
11	69927946	.	A	G	3	2	5	0	0	5	0	0
11	69927953	.	A	G	3	2	5	0	0	5	0	0
11	69928014	.	A	G	3	2	5	0	0	5	0	0
11	70898338	.	A	G	7	2	9	0	1	10	0	0
11	72816636	.	T	A	9	2	11	0	2	13	0	0
11	75067170	.	T	C	14	10	24	0	0	24	0	0
11	75067258	.	T	C	24	14	38	0	0	38	0	0
11	75068285	.	T	C	35	6	41	0	1	42	0	0
11	77873990	.	T	G	5	6	11	0	2	13	0	0
11	78187443	.	A	G	3	2	5	0	0	5	0	0
11	78187460	.	A	G	2	2	4	0	0	4	0	0
11	78588120	.	T	C	5	4	9	0	0	10	1	0
11	82853392	.	A	G	3	2	5	0	0	5	0	0
11	82853421	.	A	G	0	2	2	0	0	2	0	0
11	82854054	.	A	G	2	5	7	0	0	7	0	0
11	82854512	.	A	G	3	2	5	0	0	5	0	0
11	87013527	.	C	T	8	3	11	0	0	11	0	0
11	88619223	.	T	C	4	2	6	0	0	6	0	0
11	88927208	.	T	C	13	17	30	0	0	30	0	0
11	88928673	.	T	C	5	4	9	0	0	9	0	0
11	94431300	.	T	C	5	2	7	0	0	7	0	0
11	94431318	.	T	C	5	4	9	0	0	9	0	0
11	94431502	.	T	C	12	3	15	0	0	15	0	0
11	94431842	.	T	C	9	2	11	0	0	11	0	0
11	94432839	.	T	C	8	4	12	0	0	12	0	0
11	94432859	.	T	C	13	5	18	0	1	19	0	0
11	96855798	.	A	G	2	6	8	0	1	9	0	0
11	97285031	.	A	C	3	5	8	0	0	8	0	0
11	97535375	.	T	C	9	4	13	0	0	13	0	0
11	97535690	.	T	C	15	5	20	0	0	20	0	0
11	97734000	.	A	G	39	12	51	0	1	52	0	0
11	97734008	.	A	G	46	9	55	0	0	55	0	0
11	98168819	.	A	G	5	1	6	0	1	7	0	0
11	98291186	.	G	A	4	2	6	0	0	6	0	0
11	100488792	.	T	C	7	6	13	0	0	13	0	0
11	101089107	.	T	C	8	3	11	0	0	11	0	0
11	101089126	.	T	C	7	3	10	0	0	10	0	0
11	101089637	.	T	C	14	3	17	0	0	17	0	0
11	101089729	.	T	C	9	5	14	0	0	14	0	0
11	101089734	.	T	C	11	3	14	0	1	15	0	0
11	101089802	.	T	C	8	6	14	0	0	14	0	0
11	104220906	.	G	A	10	6	16	0	3	19	0	0
11	106054182	.	A	G	8	3	11	0	0	11	0	0
11	107102525	.	G	T	10	3	13	0	3	16	0	0
11	107102528	.	G	T	11	1	12	0	4	16	0	0
11	110966369	.	C	T	7	2	9	0	0	9	0	0
11	114785564	.	A	G	2	1	3	0	0	3	0	0
11	116303813	.	T	C	8	5	13	0	0	13	0	0
11	116471963	.	T	C	7	29	36	0	1	38	1	0
11	118340752	.	T	C	4	1	5	0	1	6	0	0
11	121068751	.	G	A	0	1	1	0	0	1	0	0
12	3454168	.	A	G	44	12	56	0	1	57	0	0
12	3454248	.	A	G	19	41	60	0	2	62	0	0
12	17479425	.	T	C	9	2	11	0	4	15	0	0
12	17479431	.	G	C	10	3	13	0	2	15	0	0
12	17479809	.	A	G	10	13	23	0	0	23	0	0
12	17479846	.	A	G	17	3	20	0	1	21	0	0
12	32429287	.	T	C	6	1	7	0	0	7	0	0
12	32429288	.	G	A	6	1	7	0	0	7	0	0
12	46747117	.	T	C	34	12	46	0	0	46	0	0
12	54718540	.	T	C	22	4	26	0	1	27	0	0
12	54718556	.	T	C	21	4	25	0	0	25	0	0
12	54719142	.	T	C	25	7	32	0	0	32	0	0
12	55102739	.	T	C	2	3	5	0	0	5	0	0
12	64988276	.	A	G	3	2	5	0	0	5	0	0
12	65113982	.	T	C	4	2	6	0	0	6	0	0
12	69244102	.	A	G	24	6	30	0	0	30	0	0
12	69347175	.	A	G	1	4	5	0	0	5	0	0
12	71009598	.	A	T	0	2	2	0	4	6	0	0
12	71009599	.	C	T	1	3	4	0	2	6	0	0
12	71041903	.	A	G	8	12	20	0	0	20	0	0
12	71041909	.	A	G	17	3	20	0	0	20	0	0
12	71041954	.	A	G	15	9	24	0	2	26	0	0
12	71041984	.	A	G	22	11	33	0	1	34	0	0
12	71180745	.	T	C	11	3	14	0	1	15	0	0
12	72955837	.	T	C	3	6	9	0	0	9	0	0
12	72955848	.	T	C	5	8	13	0	1	14	0	0
12	73975614	.	A	G	1	2	3	0	0	3	0	0
12	75677928	.	A	G	3	2	5	1	1	7	0	0
12	75678010	.	C	T	2	3	5	3	0	8	0	0
12	78887986	.	T	C	7	3	10	0	0	10	0	0
12	80154594	.	C	T	10	4	14	0	4	18	0	0
12	80682600	.	T	C	1	2	3	0	0	3	0	0
12	80770523	.	A	G	1	2	3	0	0	3	0	0
12	84484319	.	A	G	4	2	6	0	0	6	0	0
12	87203355	.	A	G	2	4	6	0	0	6	0	0
12	91556413	.	G	A	0	1	1	0	2	3	0	0
12	91605386	.	T	C	7	2	9	0	1	10	0	0
12	100825900	.	C	A	1	0	1	0	0	1	0	0
12	100825911	.	G	T	0	1	1	0	0	1	0	0
12	100843672	.	T	C	8	2	10	0	0	10	0	0
12	101885469	.	T	A	7	2	9	0	0	9	0	0
12	101886131	.	T	C	19	8	27	0	2	29	0	0
12	101887890	.	T	C	14	8	22	0	0	22	0	0
12	108654770	.	T	C	10	3	13	0	0	13	0	0
13	3702325	.	A	G	8	2	10	0	0	10	0	0
13	8901801	.	T	C	13	8	21	0	0	21	0	0
13	14225628	.	T	C	36	9	45	0	2	47	0	0
13	14226674	.	T	C	38	8	46	0	0	46	0	0
13	17979133	.	T	C	6	6	12	0	0	12	0	0
13	21574074	.	T	C	8	3	11	0	0	11	0	0
13	21574169	.	T	C	5	3	8	0	0	8	0	0
13	21574188	.	T	C	8	3	11	0	0	11	0	0
13	21576591	.	T	C	2	4	6	0	0	6	0	0
13	21576650	.	T	C	5	2	7	0	0	7	0	0
13	24196832	.	A	G	8	2	10	0	0	10	0	0
13	24999535	.	A	G	4	4	8	0	0	8	0	0
13	24999573	.	A	G	3	3	6	0	0	6	0	0
13	30997931	.	A	G	5	2	7	0	0	7	0	0
13	36914573	.	T	C	4	1	5	0	0	5	0	0
13	38228991	.	A	G	1	3	4	0	0	4	0	0
13	38410965	.	T	C	7	2	9	0	0	9	0	0
13	45709825	.	G	A	0	2	2	0	1	3	0	0
13	45709828	.	C	A	0	2	2	0	1	3	0	0
13	49684993	.	A	G	4	2	6	0	0	6	0	0
13	49958972	.	A	G	0	1	1	0	0	1	0	0
13	54206450	.	G	A	18	6	24	0	4	28	0	0
13	59757011	.	A	G	1	5	6	0	0	6	0	0
13	64438124	.	T	C	8	3	11	0	0	11	0	0
13	65214229	.	G	A	7	5	12	0	3	15	0	0
13	67621265	.	T	C	5	4	9	0	1	10	0	0
13	67621455	.	T	C	4	6	10	0	0	10	0	0
13	67806944	.	T	C	3	2	5	0	0	5	0	0
13	67806962	.	T	C	1	4	5	0	0	5	0	0
13	67814292	.	T	C	6	2	8	0	1	9	0	0
13	67814569	.	T	C	3	2	5	0	0	5	0	0
13	75793212	.	C	T	0	4	4	4	0	8	0	0
13	81213662	.	T	C	0	3	3	0	0	3	0	0
13	89873597	.	C	T	5	1	6	0	0	6	0	0
13	90258625	.	G	A	7	2	9	0	0	9	0	0
13	92903734	.	C	A	2	1	3	0	0	3	0	0
13	119625401	.	G	T	9	3	12	0	0	12	0	0
13	120227323	.	G	T	9	7	16	0	2	18	0	0
14	10058181	.	A	G	44	21	65	0	1	66	0	0
14	14533725	.	T	C	0	10	10	0	0	10	0	0
14	21846832	.	A	G	10	46	56	0	2	58	0	0
14	21847779	.	A	G	70	20	90	0	0	90	0	0
14	27205403	.	A	G	4	2	6	0	0	6	0	0
14	29788070	.	T	C	10	6	16	0	0	16	0	0
14	29788078	.	T	C	8	4	12	0	0	12	0	0
14	30698016	.	A	G	3	2	5	0	0	5	0	0
14	31422583	.	T	C	31	19	50	0	0	50	0	0
14	31422619	.	T	C	26	19	45	0	0	45	0	0
14	32018582	.	A	G	32	16	48	0	0	48	0	0
14	33953385	.	T	C	0	2	2	0	0	2	0	0
14	33953408	.	T	C	5	2	7	0	0	7	0	0
14	47558234	.	A	G	6	4	10	0	0	10	0	0
14	47558247	.	A	G	5	2	7	0	0	7	0	0
14	51013458	.	T	C	8	2	10	0	1	11	0	0
14	51109987	.	A	G	5	4	9	0	0	9	0	0
14	51115833	.	A	G	7	5	12	0	0	12	0	0
14	52243661	.	A	C	3	2	5	0	3	8	0	0
14	52531686	.	A	G	17	73	90	0	0	90	0	0
14	55749057	.	A	G	13	5	18	0	0	18	0	0
14	57880877	.	T	C	3	1	4	0	0	4	0	0
14	60451313	.	T	C	2	4	6	0	0	6	0	0
14	62930805	.	G	A	4	2	6	0	1	7	0	0
14	63198144	.	C	T	8	1	9	0	1	10	0	0
14	63198151	.	G	T	9	1	10	0	1	11	0	0
14	65434640	.	T	C	35	22	57	0	0	57	0	0
14	70314716	.	T	C	9	2	11	0	14	25	0	0
14	75002532	.	G	A	2	1	3	0	0	3	0	0
14	75957159	.	T	C	16	6	22	0	0	22	0	0
14	78061552	.	A	G	2	2	4	0	0	4	0	0
14	87654123	.	C	T	1	1	2	0	0	2	0	0
14	99311216	.	G	A	2	4	6	0	0	6	0	0
14	103584115	.	T	C	13	10	23	0	0	23	0	0
14	105546600	.	T	A	25	2	27	0	9	36	0	0
14	121273016	.	A	G	5	6	11	0	0	11	0	0
15	8187674	.	A	G	6	10	16	0	0	16	0	0
15	8188973	.	A	G	2	5	7	0	3	10	0	0
15	9112484	.	C	T	3	2	5	0	0	5	0	0
15	9199559	.	A	G	19	17	36	0	1	37	0	0
15	9199560	.	A	G	30	6	36	0	1	37	0	0
15	34117788	.	T	C	3	2	5	0	0	5	0	0
15	55118258	.	A	G	15	4	19	0	1	20	0	0
15	55118708	.	A	G	8	2	10	0	2	12	0	0
15	78900113	.	T	C	1	2	3	0	0	3	0	0
15	80144828	.	A	G	6	2	8	0	0	8	0	0
15	80816548	.	A	G	7	2	9	0	0	9	0	0
15	81339166	.	A	G	6	3	9	0	0	9	0	0
15	81341124	.	A	G	3	3	6	0	0	6	0	0
15	81578879	.	A	G	9	3	12	0	0	12	0	0
15	81733027	.	C	T	5	1	6	0	0	6	0	0
15	82015758	.	A	G	5	1	6	0	0	6	0	0
15	82015761	.	A	G	4	2	6	0	0	6	0	0
15	82178770	.	C	A	7	2	9	0	0	9	0	0
15	82178773	.	T	A	5	2	7	0	1	9	1	0
15	89171187	.	A	T	5	1	6	0	3	9	0	0
15	89171188	.	A	T	5	2	7	0	2	9	0	0
15	93388677	.	C	G	6	3	9	0	3	12	0	0
15	93388679	.	A	G	7	3	10	0	2	12	0	0
15	96300178	.	G	A	6	4	10	0	1	11	0	0
15	98533031	.	A	C	19	9	28	0	2	30	0	0
15	98634993	.	T	C	10	17	27	0	0	27	0	0
15	98634994	.	T	C	23	4	27	0	0	27	0	0
15	99142536	.	T	C	7	3	10	0	0	10	0	0
15	99626049	.	A	G	5	3	8	0	1	9	0	0
15	99626051	.	A	G	4	5	9	0	0	9	0	0
15	99626091	.	A	G	5	2	7	0	1	8	0	0
15	102543569	.	C	T	0	3	3	1	0	4	0	0
16	3680985	.	T	C	23	6	29	0	0	29	0	0
16	4444211	.	T	C	2	3	5	0	0	5	0	0
16	4444240	.	T	C	1	3	4	0	0	4	0	0
16	13520445	.	A	G	22	8	30	0	1	31	0	0
16	13650452	.	A	G	3	5	8	0	0	8	0	0
16	13651794	.	G	T	3	2	5	0	1	6	0	0
16	13651795	.	G	T	3	3	6	0	0	6	0	0
16	16844922	.	A	G	3	1	4	0	0	4	0	0
16	16844952	.	A	G	2	3	5	0	0	5	0	0
16	16866848	.	A	G	2	2	4	0	0	4	0	0
16	17321752	.	A	G	12	4	16	0	0	16	0	0
16	18653678	.	A	G	30	19	49	0	1	50	0	0
16	19942498	.	A	G	20	9	29	0	0	29	0	0
16	20350344	.	C	T	17	3	20	0	2	22	0	0
16	20350345	.	C	T	16	3	19	0	3	22	0	0
16	22200416	.	C	A	33	10	43	0	7	50	0	0
16	30330690	.	T	C	7	1	8	0	1	9	0	0
16	30330773	.	T	C	9	2	11	0	0	11	0	0
16	32118699	.	A	G	11	5	16	0	1	17	0	0
16	32119106	.	A	G	26	5	31	0	0	31	0	0
16	32119150	.	A	G	9	19	28	0	0	28	0	0
16	32209076	.	C	T	7	4	11	0	0	11	0	0
16	35749583	.	G	A	3	2	5	0	0	5	0	0
16	37656108	.	G	A	4	3	7	0	2	9	0	0
16	43446292	.	G	A	4	2	6	0	0	6	0	0
16	43460151	.	T	G	5	4	9	0	2	11	0	0
16	43461391	.	T	C	10	3	13	0	0	13	0	0
16	43691361	.	T	C	5	2	7	0	0	7	0	0
16	55837428	.	G	A	5	3	8	0	11	19	0	0
16	57028551	.	A	G	6	0	6	0	0	6	0	0
16	81420648	.	G	T	10	6	16	0	2	18	0	0
16	81420650	.	C	T	11	2	13	0	4	18	1	0
16	87230813	.	T	C	6	4	10	0	0	10	0	0
16	87230814	.	T	C	6	3	9	0	1	10	0	0
16	87231013	.	T	C	14	8	22	0	0	22	0	0
16	87231014	.	T	C	15	6	21	0	1	22	0	0
16	91452503	.	A	G	99	20	119	0	3	122	0	0
16	91453021	.	A	G	66	27	93	0	2	95	0	0
17	6330948	.	T	C	0	0	0	0	1	1	0	0
17	15742534	.	A	G	4	3	7	0	0	7	0	0
17	18050496	.	A	G	2	5	7	0	0	7	0	0
17	21943290	.	A	G	5	3	8	0	0	8	0	0
17	23984765	.	T	C	5	2	7	0	1	8	0	0
17	24395428	.	T	C	64	14	78	0	1	79	0	0
17	24396788	.	T	C	64	14	78	0	1	79	0	0
17	24635802	.	A	G	5	2	7	0	0	7	0	0
17	25404688	.	C	T	7	4	11	0	1	12	0	0
17	25404690	.	C	T	7	1	8	0	4	12	0	0
17	26234947	.	G	A	18	23	41	0	1	42	0	0
17	26916534	.	A	G	5	3	8	0	0	8	0	0
17	26916593	.	A	G	7	3	10	0	0	10	0	0
17	29521001	.	A	G	3	3	6	0	0	6	0	0
17	30428210	.	G	A	8	2	10	0	1	11	0	0
17	31748326	.	A	G	1	3	4	0	0	4	0	0
17	32523565	.	T	C	16	9	25	0	0	25	0	0
17	33015107	.	T	C	8	10	18	0	0	18	0	0
17	33015482	.	T	C	9	3	12	0	0	12	0	0
17	33550719	.	T	C	13	3	16	0	0	16	0	0
17	33552004	.	T	C	13	4	17	0	1	18	0	0
17	33600221	.	C	T	7	3	10	0	0	10	0	0
17	35966647	.	T	C	6	2	8	0	0	8	0	0
17	36168626	.	A	G	2	3	5	0	1	6	0	0
17	36169789	.	A	G	2	2	4	0	0	4	0	0
17	40158498	.	T	C	2672	3508	6180	0	92	6579	307	0
17	45973875	.	T	C	10	26	36	0	9	45	0	0
17	46810304	.	A	G	7	3	10	0	0	10	0	0
17	46811636	.	A	T	9	1	10	0	0	10	0	0
17	47085856	.	T	C	18	12	30	0	0	30	0	0
17	47085857	.	T	C	16	14	30	0	0	30	0	0
17	52166231	.	A	G	3	5	8	0	0	8	0	0
17	52166256	.	A	G	2	3	5	0	0	5	0	0
17	78682975	.	G	T	3	3	6	0	0	6	0	0
17	95042896	.	G	A	5	2	7	0	1	8	0	0
17	95064364	.	T	C	8	3	11	0	0	11	0	0
17	95067396	.	T	C	9	4	13	0	1	14	0	0
17	95067479	.	T	C	11	16	27	0	0	27	0	0
17	95067803	.	T	C	32	6	38	0	0	38	0	0
17	95119983	.	T	C	2	2	4	0	0	4	0	0
17	95123373	.	T	C	1	2	3	0	0	3	0	0
17	95123375	.	T	C	0	1	1	0	2	3	0	0
17	95183666	.	G	A	1	2	3	0	0	3	0	0
18	6792650	.	A	G	23	7	30	0	0	30	0	0
18	6792739	.	A	G	14	7	21	0	0	21	0	0
18	6792757	.	A	G	19	4	23	0	0	23	0	0
18	6792826	.	A	G	19	4	23	0	1	24	0	0
18	6793746	.	A	G	21	6	27	0	0	27	0	0
18	6793749	.	A	G	17	10	27	0	0	27	0	0
18	21261539	.	C	T	5	2	7	0	3	10	0	0
18	25270986	.	C	A	4	2	6	0	1	7	0	0
18	32235557	.	A	G	5	3	8	0	0	8	0	0
18	32235643	.	A	G	3	13	16	0	0	17	1	0
18	32235652	.	A	G	0	14	14	0	0	14	0	0
18	32235930	.	A	G	3	3	6	0	0	6	0	0
18	32561134	.	A	G	37	9	46	0	2	49	1	0
18	34998034	.	G	A	3	2	5	0	1	6	0	0
18	35743341	.	A	G	7	4	11	0	0	11	0	0
18	35807586	.	T	C	61	10	71	0	3	74	0	0
18	37870577	.	G	A	7	2	9	0	0	9	0	0
18	38596909	.	A	G	3	3	6	0	0	6	0	0
18	38596914	.	A	G	3	3	6	0	0	6	0	0
18	54118380	.	C	T	0	1	1	0	0	1	0	0
18	57090012	.	T	C	2	11	13	0	0	13	0	0
18	75527605	.	G	T	8	4	12	0	1	13	0	0
18	77062550	.	A	G	9	13	22	0	0	22	0	0
18	77062557	.	A	G	17	6	23	0	0	23	0	0
18	77549372	.	C	T	10	2	12	0	2	14	0	0
18	82613560	.	C	A	7	2	9	0	0	9	0	0
19	3917362	.	A	G	10	3	13	0	0	13	0	0
19	3917363	.	A	G	11	2	13	0	0	13	0	0
19	4367156	.	G	A	27	3	30	0	5	35	0	0
19	4811022	.	T	C	3	2	5	0	0	5	0	0
19	4811046	.	A	G	5	1	6	0	0	6	0	0
19	4811133	.	T	C	4	2	6	0	0	6	0	0
19	6895771	.	T	C	6	2	8	0	0	8	0	0
19	6895783	.	T	C	5	2	7	0	0	7	0	0
19	7072231	.	G	A	6	2	8	0	0	8	0	0
19	7254111	.	C	T	18	11	29	0	4	33	0	0
19	7402857	.	A	C	6	2	8	0	1	9	0	0
19	7402866	.	A	C	8	2	10	0	1	11	0	0
19	7515480	.	A	G	16	5	21	0	0	21	0	0
19	8868627	.	A	G	7	2	9	0	0	9	0	0
19	8900145	.	A	G	1	4	5	0	0	5	0	0
19	8900203	.	A	G	4	4	8	0	0	8	0	0
19	10223060	.	T	C	37	79	116	0	5	121	0	0
19	10607183	.	G	A	3	2	5	0	0	5	0	0
19	16256046	.	T	C	1	1	2	0	0	2	0	0
19	16256052	.	G	T	1	1	2	0	0	2	0	0
19	23184773	.	A	G	3	2	5	0	0	5	0	0
19	28995964	.	A	G	24	4	28	0	2	30	0	0
19	28997203	.	A	G	18	3	21	0	0	21	0	0
19	32643020	.	C	T	9	3	12	0	0	12	0	0
19	40729432	.	A	G	5	3	8	0	0	8	0	0
19	40729466	.	A	G	1	5	6	0	0	6	0	0
19	41818939	.	A	G	14	3	17	0	0	17	0	0
19	41931486	.	A	G	7	2	9	0	0	9	0	0
19	42181800	.	A	C	9	4	13	0	3	16	0	0
19	43429365	.	A	G	18	6	24	0	0	24	0	0
19	43429601	.	A	G	15	15	30	0	1	31	0	0
19	43429686	.	A	G	42	11	53	0	0	53	0	0
19	43429753	.	A	G	31	5	36	0	0	36	0	0
19	43493214	.	C	T	1	2	3	0	1	4	0	0
19	44130363	.	T	C	2	2	4	0	1	5	0	0
19	44130371	.	T	C	1	3	4	0	1	5	0	0
19	45324251	.	T	C	6	2	8	0	0	8	0	0
19	46318508	.	T	C	3	2	5	0	0	5	0	0
19	46584105	.	A	G	2	3	5	0	0	5	0	0
19	46873008	.	A	G	8	2	10	0	0	10	0	0
19	47072011	.	A	G	7	1	8	0	0	8	0	0
19	53920935	.	T	C	3	2	5	0	0	5	0	0
19	60765148	.	A	G	18	20	38	0	2	40	0	0
2	5902768	.	T	C	2	1	3	0	1	4	0	0
2	13016235	.	C	T	17	6	23	0	10	33	0	0
2	14152798	.	A	G	13	4	17	0	0	17	0	0
2	14152860	.	A	G	25	3	28	0	0	28	0	0
2	14153560	.	A	G	4	9	13	0	0	13	0	0
2	14153568	.	A	G	7	8	15	0	1	16	0	0
2	18219533	.	T	C	6	2	8	0	0	8	0	0
2	18219540	.	T	C	7	4	11	0	1	12	0	0
2	18220170	.	T	C	7	3	10	0	1	11	0	0
2	18220174	.	T	C	6	5	11	0	0	11	0	0
2	26271752	.	A	G	1	1	2	0	0	2	0	0
2	26271758	.	A	G	0	2	2	0	0	2	0	0
2	26800818	.	C	T	2	1	3	0	0	3	0	0
2	26846568	.	T	C	8	2	10	0	0	10	0	0
2	27153718	.	T	C	6	2	8	0	1	9	0	0
2	32174582	.	T	C	7	2	9	0	0	9	0	0
2	32196762	.	A	G	49	12	61	0	0	61	0	0
2	32304513	.	A	G	3	2	5	0	0	5	0	0
2	32506344	.	A	G	1	1	2	0	0	2	0	0
2	32506353	.	A	G	1	2	3	0	0	3	0	0
2	37319075	.	A	G	11	3	14	0	0	14	0	0
2	40446129	.	C	G	0	2	2	3	0	5	0	0
2	49198973	.	T	C	0	5	5	6	0	11	0	0
2	55005781	.	C	T	13	3	16	0	2	18	0	0
2	55005783	.	G	T	14	3	17	0	1	18	0	0
2	60078304	.	G	A	15	7	22	0	2	24	0	0
2	77012350	.	A	C	12	3	15	0	6	21	0	0
2	77012356	.	A	C	12	6	18	0	5	23	0	0
2	91064732	.	T	C	3	2	5	0	0	5	0	0
2	91064743	.	T	C	3	1	4	0	0	4	0	0
2	91551767	.	A	G	1	2	3	0	0	3	0	0
2	104398328	.	A	G	1	2	3	0	0	3	0	0
2	104511117	.	T	C	19	6	25	0	0	25	0	0
2	112185846	.	A	G	1	2	3	0	0	3	0	0
2	112185852	.	A	G	3	2	5	0	0	5	0	0
2	118577740	.	C	T	30	8	38	1	2	41	0	0
2	118700340	.	A	G	11	5	16	0	0	16	0	0
2	118700366	.	A	G	10	6	16	0	0	16	0	0
2	118700801	.	A	G	9	3	12	0	1	13	0	0
2	119648581	.	T	A	3	3	6	0	0	6	0	0
2	119648582	.	C	A	3	3	6	0	0	6	0	0
2	120451649	.	A	G	23	4	27	0	0	27	0	0
2	120564258	.	T	C	18	19	37	0	0	37	0	0
2	120564286	.	T	C	31	9	40	0	0	40	0	0
2	120564302	.	T	C	21	19	40	0	0	40	0	0
2	120567433	.	T	C	12	16	28	0	2	30	0	0
2	120567456	.	T	C	1	4	5	0	0	5	0	0
2	120567482	.	T	C	31	11	42	0	0	42	0	0
2	121015462	.	A	G	3	2	5	0	0	5	0	0
2	121178337	.	T	C	1	2	3	0	0	3	0	0
2	124930620	.	C	A	3	4	7	0	0	7	0	0
2	126734836	.	T	C	14	7	21	0	0	21	0	0
2	126734839	.	T	C	11	8	19	0	0	19	0	0
2	131141887	.	A	C	1	3	4	0	1	5	0	0
2	131141893	.	A	C	5	2	7	0	1	8	0	0
2	132151800	.	A	G	53	279	332	0	1	333	0	0
2	132636996	.	C	A	4	2	6	0	1	7	0	0
2	139599621	.	A	G	4	2	6	0	0	6	0	0
2	149585919	.	C	T	0	2	2	0	0	2	0	0
2	153051040	.	C	T	3	6	9	0	12	23	2	0
2	153459196	.	T	C	1	3	4	0	0	4	0	0
2	154379850	.	A	G	38	8	46	0	0	46	0	0
2	154428307	.	T	C	2	4	6	0	0	6	0	0
2	156252897	.	G	A	0	2	2	0	0	2	0	0
2	156252900	.	A	G	0	2	2	0	0	2	0	0
2	156563781	.	A	C	20	6	26	0	6	32	0	0
2	157313041	.	A	C	8	5	13	0	8	21	0	0
2	157400030	.	T	C	73	22	95	0	3	98	0	0
2	157400060	.	T	C	70	31	101	0	3	105	1	0
2	157400069	.	T	C	60	41	101	0	0	101	0	0
2	158219451	.	A	G	8	3	11	0	0	11	0	0
2	158220838	.	A	G	13	7	20	0	0	20	0	0
2	158225545	.	A	G	361	80	441	0	0	441	0	0
2	158226873	.	A	G	95	468	563	1	14	578	0	0
2	163309459	.	T	C	7	6	13	0	0	13	0	0
2	164306821	.	G	A	16	4	20	1	4	25	0	0
2	164761458	.	A	G	4	3	7	0	0	7	0	0
2	164953773	.	T	C	32	11	43	0	0	43	0	0
2	168057882	.	T	C	5	2	7	0	0	7	0	0
2	169913325	.	A	G	1	2	3	0	0	3	0	0
2	169913383	.	A	G	6	2	8	0	1	9	0	0
2	169913421	.	A	G	5	3	8	0	0	8	0	0
2	174169694	.	A	G	55	12	67	0	2	70	1	0
2	174548497	.	C	T	7	5	12	0	5	17	0	0
2	181006654	.	A	G	4	2	6	0	0	6	0	0
3	8681198	.	T	C	2	0	2	0	0	2	0	0
3	8681220	.	C	T	1	0	1	0	0	1	0	0
3	40748697	.	A	G	31	10	41	0	0	41	0	0
3	57553324	.	T	C	4	2	6	0	0	6	0	0
3	57553351	.	T	C	1	5	6	0	0	6	0	0
3	60525133	.	A	G	5	2	7	0	0	7	0	0
3	65866428	.	A	G	5	4	9	0	0	9	0	0
3	80599593	.	T	C	8	63	71	0	0	71	0	0
3	80613850	.	T	C	27	5	32	0	0	32	0	0
3	80614159	.	T	C	6	10	16	0	0	17	1	0
3	80614215	.	T	C	88	51	139	0	2	141	0	0
3	87828994	.	A	G	2	4	6	0	0	6	0	0
3	88079367	.	G	A	7	6	13	0	2	15	0	0
3	88318976	.	C	T	23	6	29	0	5	34	0	0
3	88318978	.	G	T	24	4	28	0	6	34	0	0
3	89090052	.	G	A	7	4	11	0	2	13	0	0
3	89660763	.	C	A	2	2	4	0	0	4	0	0
3	89675221	.	T	C	10	4	14	1	0	15	0	0
3	89967938	.	A	G	3	2	5	0	0	5	0	0
3	90389480	.	A	G	1	2	3	0	0	3	0	0
3	95090893	.	T	C	3	3	6	0	0	6	0	0
3	95091616	.	T	C	5	2	7	0	0	7	0	0
3	95768692	.	T	C	3	2	5	0	0	5	0	0
3	96066954	.	C	A	0	3	3	0	0	3	0	0
3	96485585	.	T	C	12	5	17	0	0	17	0	0
3	96539776	.	A	G	6	18	24	0	2	26	0	0
3	96540029	.	A	G	22	7	29	0	3	32	0	0
3	97134574	.	T	C	4	2	6	0	0	6	0	0
3	100375793	.	T	C	3	2	5	0	0	5	0	0
3	101483698	.	G	C	14	15	29	0	19	48	0	0
3	101483703	.	G	C	29	9	38	0	19	57	0	0
3	102973406	.	A	G	43	10	53	0	3	56	0	0
3	104835351	.	A	G	4	2	6	0	0	6	0	0
3	116537733	.	T	C	9	7	16	0	0	16	0	0
3	116537746	.	T	C	9	6	15	0	0	15	0	0
3	116537808	.	T	C	12	4	16	0	0	16	0	0
3	116537812	.	T	C	12	5	17	0	0	17	0	0
3	116538330	.	T	C	0	6	6	0	0	6	0	0
3	116538353	.	T	C	9	4	13	0	0	13	0	0
3	119541047	.	A	G	3	2	5	0	0	5	0	0
3	135112631	.	T	C	42	11	53	0	1	54	0	0
3	135160630	.	A	G	1	2	3	0	0	3	0	0
3	138264847	.	A	G	3	2	5	0	0	5	0	0
3	138265030	.	A	G	8	2	10	0	0	10	0	0
3	143894308	.	C	T	8	2	10	0	0	10	0	0
3	146435333	.	A	T	3	3	6	0	0	6	0	0
3	152165410	.	C	A	2	1	3	0	2	5	0	0
3	152166703	.	T	C	3	2	5	0	1	6	0	0
4	14914453	.	G	T	4	4	8	0	3	11	0	0
4	14914456	.	A	T	6	2	8	0	1	9	0	0
4	21834757	.	A	G	19	4	23	0	0	23	0	0
4	21834791	.	A	G	6	5	11	0	0	11	0	0
4	21836550	.	A	G	49	9	58	0	1	59	0	0
4	21911667	.	A	G	1	8	9	0	0	9	0	0
4	21911675	.	A	G	7	2	9	0	0	9	0	0
4	33019420	.	A	G	74	38	112	0	2	114	0	0
4	33020417	.	A	G	57	69	126	0	2	128	0	0
4	41169380	.	A	G	0	3	3	0	0	3	0	0
4	41169386	.	T	C	0	3	3	0	0	3	0	0
4	42219588	.	C	T	1	0	1	0	0	1	0	0
4	46538360	.	A	G	17	6	23	0	7	30	0	0
4	56870581	.	G	T	6	4	10	0	1	11	0	0
4	56995087	.	A	T	6	3	9	0	2	11	0	0
4	56995088	.	G	T	6	0	6	0	5	11	0	0
4	82212633	.	G	A	6	4	10	0	3	13	0	0
4	82212637	.	C	A	5	3	8	0	5	13	0	0
4	83113025	.	A	G	0	1	1	0	0	1	0	0
4	86495344	.	G	T	55	9	64	0	1	65	0	0
4	107701489	.	A	G	1	2	3	0	0	3	0	0
4	108198318	.	A	G	8	4	12	0	0	12	0	0
4	108494684	.	T	C	9	2	11	0	0	11	0	0
4	115991567	.	T	C	17	9	26	0	0	26	0	0
4	116410153	.	A	G	9	2	11	0	0	11	0	0
4	118483276	.	A	G	14	5	19	0	1	20	0	0
4	118484005	.	A	G	9	18	27	0	1	28	0	0
4	118484072	.	A	G	16	7	23	0	1	24	0	0
4	119081410	.	T	C	7	3	10	0	0	10	0	0
4	122948301	.	C	T	13	4	17	0	1	18	0	0
4	124838094	.	A	G	12	11	23	0	0	23	0	0
4	124838169	.	A	G	15	7	22	0	0	22	0	0
4	125982775	.	A	G	13	3	16	0	0	16	0	0
4	125982944	.	A	G	14	11	25	0	0	25	0	0
4	125982989	.	A	G	11	4	15	0	0	15	0	0
4	125984993	.	A	G	6	2	8	0	0	8	0	0
4	126920377	.	A	G	5	3	8	0	0	8	0	0
4	126929461	.	G	T	12	7	19	1	1	21	0	0
4	129062418	.	T	C	1	2	3	0	1	4	0	0
4	129074340	.	T	C	1	2	3	0	0	3	0	0
4	131678229	.	T	C	5	2	7	0	0	7	0	0
4	132219566	.	C	A	6	1	7	0	0	7	0	0
4	132219567	.	T	G	6	1	7	0	0	7	0	0
4	133389520	.	T	C	4	5	9	0	0	9	0	0
4	133836902	.	A	G	5	2	7	0	0	7	0	0
4	135590924	.	G	T	6	1	7	0	1	8	0	0
4	135590930	.	G	T	6	1	7	0	1	8	0	0
4	137987341	.	A	G	85	21	106	0	0	106	0	0
4	137987354	.	A	G	64	38	102	0	1	103	0	0
4	140678893	.	A	G	11	5	16	0	0	16	0	0
4	141488012	.	T	C	44	8	52	0	0	52	0	0
4	144314687	.	A	G	4	1	5	0	1	6	0	0
4	147891580	.	C	A	0	0	0	0	1	1	0	0
4	147891589	.	G	A	0	1	1	0	0	1	0	0
4	147907770	.	T	C	4	2	6	0	0	6	0	0
4	147907775	.	T	C	4	2	6	0	0	6	0	0
4	147907821	.	T	C	4	2	6	0	0	6	0	0
4	149202586	.	A	G	24	13	37	0	0	37	0	0
4	149202654	.	A	G	27	6	33	0	1	34	0	0
4	149203211	.	A	G	15	6	21	0	0	21	0	0
4	149552777	.	T	C	4	3	7	0	0	7	0	0
4	149552779	.	T	C	4	3	7	0	0	7	0	0
4	149552818	.	T	C	0	5	5	0	0	5	0	0
4	149552913	.	T	A	2	2	4	0	0	4	0	0
4	151089106	.	G	A	0	1	1	0	0	1	0	0
4	151089109	.	G	A	0	0	0	0	1	1	0	0
4	152097102	.	T	G	11	2	13	0	1	14	0	0
4	152097103	.	C	A	11	2	13	0	1	14	0	0
4	155344796	.	A	C	32	5	37	0	29	66	0	0
4	155705891	.	A	G	2	3	5	0	0	5	0	0
4	155705922	.	A	G	1	0	1	0	0	1	0	0
4	155705947	.	A	G	4	3	7	0	0	7	0	0
4	155706774	.	A	G	6	2	8	0	1	9	0	0
4	155706828	.	A	G	4	8	12	0	1	13	0	0
4	155800270	.	C	T	0	3	3	0	1	4	0	0
4	155800341	.	A	G	5	2	7	0	0	7	0	0
4	155800382	.	A	G	8	4	12	0	0	12	0	0
4	155800422	.	A	G	12	2	14	0	0	14	0	0
4	156095123	.	A	G	82	46	128	0	2	130	0	0
5	5833142	.	A	G	0	5	5	2	0	7	0	0
5	23698014	.	A	G	2	2	4	0	0	4	0	0
5	25430722	.	A	G	4	4	8	0	0	8	0	0
5	25430743	.	A	G	12	2	14	0	0	14	0	0
5	25477416	.	C	T	11	4	15	0	1	16	0	0
5	26055676	.	T	C	4	2	6	0	0	6	0	0
5	26055685	.	T	A	1	2	3	0	0	3	0	0
5	29658129	.	A	G	1	4	5	0	0	5	0	0
5	30815805	.	T	C	3	2	5	0	2	7	0	0
5	31316473	.	T	A	13	7	20	0	0	20	0	0
5	31330824	.	T	C	6	4	10	0	0	10	0	0
5	33149571	.	A	G	5	2	7	0	0	7	0	0
5	33149943	.	A	G	11	5	16	0	0	16	0	0
5	33573262	.	A	G	3	5	8	0	0	8	0	0
5	33573281	.	A	G	2	6	8	0	0	8	0	0
5	33573900	.	A	G	2	2	4	0	0	4	0	0
5	41786041	.	T	C	4	2	6	0	0	6	0	0
5	63967611	.	G	A	10	4	14	0	3	17	0	0
5	63967618	.	G	A	7	5	12	0	3	15	0	0
5	65605388	.	T	C	47	31	78	0	2	80	0	0
5	65605389	.	T	C	39	37	76	0	4	80	0	0
5	66422225	.	A	G	1	2	3	0	0	3	0	0
5	69267179	.	A	G	5	3	8	0	0	8	0	0
5	71114966	.	A	G	6	2	8	0	0	8	0	0
5	73469787	.	A	G	45	17	62	0	1	63	0	0
5	77555578	.	T	C	3	15	18	0	0	18	0	0
5	89832332	.	A	T	6	1	7	0	0	7	0	0
5	104701389	.	T	A	4	2	6	0	2	8	0	0
5	110081429	.	C	T	5	4	9	0	1	10	0	0
5	110081431	.	C	T	5	4	9	0	1	10	0	0
5	111424120	.	G	T	4	1	5	0	0	5	0	0
5	115324342	.	C	T	2	2	4	0	0	4	0	0
5	121271878	.	G	A	50	11	61	0	12	73	0	0
5	121683725	.	T	C	14	6	20	0	0	20	0	0
5	121941617	.	A	G	1	3	4	0	0	4	0	0
5	122546790	.	A	G	8	3	11	0	0	11	0	0
5	122872763	.	T	C	15	3	18	0	1	19	0	0
5	123386729	.	A	G	18	15	33	0	0	33	0	0
5	123495010	.	A	G	3	2	5	0	0	5	0	0
5	123879315	.	T	C	4	14	18	0	0	18	0	0
5	123879325	.	T	C	4	8	12	0	0	12	0	0
5	123879350	.	T	C	3	3	6	0	0	6	0	0
5	123879366	.	T	C	7	3	10	0	1	11	0	0
5	123880130	.	T	C	1	3	4	0	0	4	0	0
5	124511367	.	T	A	3	1	4	0	4	8	0	0
5	125491341	.	T	C	2	2	4	0	0	4	0	0
5	125533669	.	A	G	16	52	68	0	2	70	0	0
5	125533687	.	A	G	53	15	68	0	0	68	0	0
5	125533970	.	A	G	37	9	46	0	0	46	0	0
5	125533971	.	A	G	32	12	44	0	2	46	0	0
5	125534541	.	A	G	62	31	93	0	1	94	0	0
5	128835738	.	A	G	12	7	19	0	14	33	0	0
5	129061893	.	T	C	5	1	6	0	1	7	0	0
5	129795803	.	A	G	10	4	14	0	0	14	0	0
5	129795821	.	A	G	4	5	9	0	0	9	0	0
5	129797823	.	A	G	10	16	26	0	1	27	0	0
5	129797862	.	A	G	13	3	16	0	0	16	0	0
5	129798517	.	A	G	17	5	22	0	0	22	0	0
5	130013839	.	A	G	50	8	58	0	0	58	0	0
5	130014307	.	A	G	56	11	67	0	0	67	0	0
5	134173078	.	G	A	5	13	18	0	3	21	0	0
5	134621625	.	A	G	5	2	7	0	0	7	0	0
5	135192126	.	A	G	8	3	11	0	0	11	0	0
5	135437709	.	T	C	15	13	28	0	0	28	0	0
5	135437715	.	T	C	15	11	26	0	0	26	0	0
5	135665678	.	A	G	1	3	4	0	0	4	0	0
5	135813250	.	A	T	1	1	2	0	0	2	0	0
5	136941953	.	A	G	67	14	81	0	2	83	0	0
5	140510852	.	G	C	20	4	24	0	0	25	1	0
5	142655047	.	A	G	98	19	117	0	0	117	0	0
5	142855980	.	T	C	0	3	3	0	0	3	0	0
5	142855997	.	T	C	2	0	2	0	0	2	0	0
5	142856760	.	T	C	18	6	24	0	0	24	0	0
5	142873223	.	T	C	1	2	3	0	0	3	0	0
5	142888875	.	G	T	9	11	20	0	0	20	0	0
5	142976793	.	C	T	12	3	15	0	0	15	0	0
5	143751066	.	A	G	8	3	11	0	0	11	0	0
5	143883169	.	A	G	0	2	2	0	0	2	0	0
5	145045567	.	C	A	0	3	3	0	0	3	0	0
6	12044870	.	T	C	2	1	3	0	1	4	0	0
6	21261871	.	A	G	1	2	3	0	0	3	0	0
6	29945686	.	A	G	1	2	3	0	0	3	0	0
6	31486635	.	A	C	2	3	5	0	2	7	0	0
6	31486641	.	G	C	4	2	6	0	5	11	0	0
6	31489086	.	A	G	4	8	12	0	0	12	0	0
6	31489106	.	A	G	3	2	5	0	1	6	0	0
6	31492600	.	A	G	17	4	21	0	1	22	0	0
6	31492602	.	A	G	15	6	21	0	1	22	0	0
6	31492665	.	A	G	8	3	11	0	0	11	0	0
6	31492682	.	A	G	3	7	10	0	0	10	0	0
6	31492702	.	A	G	14	3	17	0	1	18	0	0
6	37783131	.	C	T	0	5	5	2	0	7	0	0
6	37847782	.	A	G	6	2	8	0	1	9	0	0
6	38265975	.	T	C	7	2	9	0	0	9	0	0
6	38283733	.	A	G	2	2	4	0	0	4	0	0
6	39584626	.	G	A	3	6	9	0	1	10	0	0
6	39584634	.	G	A	3	5	8	0	1	9	0	0
6	47279242	.	A	T	1	3	4	0	1	5	0	0
6	47279245	.	C	T	1	2	3	0	0	3	0	0
6	47848284	.	A	G	7	5	12	0	0	12	0	0
6	49062953	.	C	T	8	2	10	0	0	10	0	0
6	49231811	.	T	C	15	5	20	0	0	20	0	0
6	49231812	.	T	C	12	7	19	0	1	20	0	0
6	49237899	.	T	C	18	5	23	0	1	24	0	0
6	51459938	.	C	T	10	11	21	0	9	30	0	0
6	65687592	.	A	G	3	5	8	0	0	8	0	0
6	65687650	.	A	G	3	2	5	0	0	5	0	0
6	65687744	.	A	G	3	2	5	0	0	5	0	0
6	66517065	.	A	G	1	3	4	0	0	4	0	0
6	66517110	.	A	G	4	5	9	0	1	10	0	0
6	66517128	.	A	G	7	5	12	0	0	12	0	0
6	66517625	.	A	G	4	6	10	0	0	10	0	0
6	66517635	.	A	G	6	3	9	0	1	10	0	0
6	66517695	.	A	G	6	2	8	0	0	8	0	0
6	66517724	.	A	G	5	3	8	0	0	8	0	0
6	66517775	.	A	G	5	4	9	0	0	9	0	0
6	71841048	.	A	G	0	2	2	0	0	2	0	0
6	71864858	.	T	C	5	2	7	0	0	7	0	0
6	85932353	.	T	C	8	4	12	0	1	13	0	0
6	96010042	.	T	C	3	2	5	4	1	10	0	0
6	96010135	.	T	C	1	3	4	0	0	4	0	0
6	96010183	.	T	C	2	2	4	2	0	6	0	0
6	119896957	.	A	G	9	2	11	0	0	11	0	0
6	124787015	.	A	G	1	7	8	0	0	8	0	0
6	124787022	.	T	G	1	7	8	0	0	8	0	0
6	125633634	.	T	C	5	1	6	0	0	6	0	0
6	126619121	.	T	C	50	20	70	0	0	70	0	0
6	127470543	.	A	C	5	2	7	0	1	8	0	0
6	134963147	.	G	T	1	1	2	0	0	2	0	0
6	146733792	.	A	G	1	2	3	0	0	3	0	0
6	148787523	.	T	C	0	2	2	0	0	2	0	0
6	148787524	.	T	C	0	2	2	0	0	2	0	0
7	3339147	.	C	G	0	3	3	0	0	3	0	0
7	3463600	.	A	G	121	23	144	0	2	146	0	0
7	3687434	.	T	C	56	9	65	0	1	66	0	0
7	6357880	.	A	G	1	2	3	0	0	3	0	0
7	6968013	.	A	G	3	7	10	0	0	10	0	0
7	6968063	.	T	G	5	5	10	0	1	11	0	0
7	6969234	.	A	G	19	4	23	0	1	24	0	0
7	6969491	.	A	G	9	2	11	0	0	11	0	0
7	6969513	.	A	G	3	12	15	0	0	15	0	0
7	12625253	.	T	C	7	2	9	0	0	9	0	0
7	16348684	.	C	T	8	2	10	0	1	11	0	0
7	16544242	.	C	T	0	10	10	0	0	10	0	0
7	16568569	.	A	C	0	2	2	0	0	2	0	0
7	16603988	.	C	A	1	7	8	0	0	8	0	0
7	16619714	.	A	G	48	23	71	0	2	73	0	0
7	18625988	.	C	T	1	3	4	0	0	4	0	0
7	18696483	.	T	C	3	7	10	0	0	10	0	0
7	18697192	.	C	T	2	19	21	0	7	28	0	0
7	18699082	.	T	A	0	6	6	0	0	6	0	0
7	18785632	.	G	C	0	2	2	0	0	2	0	0
7	19240036	.	T	C	7	3	10	0	0	10	0	0
7	19490353	.	T	C	5	2	7	0	0	7	0	0
7	19638449	.	T	A	2	3	5	0	0	5	0	0
7	19638461	.	T	A	2	3	5	0	0	5	0	0
7	24710068	.	T	C	58	16	74	0	0	74	0	0
7	24710075	.	T	C	55	13	68	0	2	70	0	0
7	26904993	.	A	G	2	9	11	0	1	12	0	0
7	26905060	.	A	G	3	3	6	0	0	6	0	0
7	27227593	.	T	C	46	14	60	0	0	60	0	0
7	27281313	.	A	G	13	2	15	0	1	16	0	0
7	27506640	.	C	T	1	0	1	0	0	1	0	0
7	27506642	.	G	A	1	0	1	0	0	1	0	0
7	27520956	.	A	G	5	2	7	0	1	8	0	0
7	27521358	.	A	G	8	2	10	0	0	10	0	0
7	28922523	.	T	C	6	2	8	0	0	8	0	0
7	29016713	.	C	T	14	4	18	0	1	19	0	0
7	29016714	.	C	T	14	4	18	0	1	19	0	0
7	29424868	.	A	C	0	1	1	0	0	1	0	0
7	30751121	.	A	G	6	2	8	0	1	10	1	0
7	45122274	.	T	C	3	2	5	0	0	5	0	0
7	45141114	.	T	C	3	3	6	0	0	6	0	0
7	49205135	.	A	G	1	3	4	0	0	4	0	0
7	49206073	.	A	G	1	2	3	0	0	3	0	0
7	55591760	.	T	C	1	2	3	0	0	3	0	0
7	55627368	.	T	C	68	24	92	0	3	95	0	0
7	59331191	.	G	C	0	1	1	0	0	1	0	0
7	59331194	.	A	C	0	1	1	0	0	1	0	0
7	60778118	.	A	C	2	2	4	0	0	4	0	0
7	73388713	.	T	C	8	2	10	0	0	10	0	0
7	79574157	.	T	C	5	2	7	0	1	8	0	0
7	80362126	.	T	C	9	2	11	0	0	11	0	0
7	81521934	.	A	G	4	2	6	0	0	6	0	0
7	81521958	.	A	G	3	3	6	0	0	6	0	0
7	81522050	.	A	G	1	4	5	0	1	6	0	0
7	81522943	.	A	G	3	2	5	0	0	5	0	0
7	83533502	.	A	C	12	1	13	0	0	13	0	0
7	83533504	.	A	C	12	1	13	0	0	13	0	0
7	87959400	.	C	T	4	2	6	0	0	6	0	0
7	116424680	.	C	T	1	0	1	0	1	2	0	0
7	121306558	.	T	C	22	4	26	1	1	28	0	0
7	121586933	.	T	C	4	2	6	0	0	6	0	0
7	121586934	.	T	C	3	3	6	0	0	6	0	0
7	121733122	.	C	T	1	1	2	0	3	5	0	0
7	123582585	.	A	G	14	3	17	0	0	17	0	0
7	126423019	.	G	C	3	4	7	0	1	8	0	0
7	126423022	.	A	C	4	4	8	0	0	8	0	0
7	126468724	.	C	T	0	1	1	0	1	2	0	0
7	126853494	.	A	G	35	12	47	0	3	50	0	0
7	127178178	.	A	G	3	3	6	0	0	6	0	0
7	127178234	.	A	G	0	2	2	0	0	2	0	0
7	130360893	.	A	T	3	10	13	0	0	13	0	0
7	131048678	.	A	G	1	2	3	0	1	4	0	0
7	131048682	.	A	G	1	3	4	0	0	4	0	0
7	139715688	.	A	G	1	4	5	0	0	5	0	0
7	139715696	.	A	G	0	4	4	0	0	4	0	0
7	140390969	.	T	C	12	5	17	0	0	17	0	0
7	140391023	.	T	C	8	7	15	0	0	15	0	0
7	140916604	.	A	G	30	9	39	0	2	41	0	0
7	141503659	.	T	C	17	4	21	0	1	22	0	0
7	141503671	.	G	C	15	0	15	0	0	15	0	0
7	142207010	.	T	C	31	12	43	0	0	43	0	0
7	144808279	.	G	A	4	1	5	0	1	6	0	0
8	3588369	.	A	G	5	2	7	0	0	7	0	0
8	3588384	.	A	G	1	3	4	0	0	4	0	0
8	17585190	.	T	C	11	1	12	0	0	12	0	0
8	19732474	.	C	A	7	4	11	0	0	11	0	0
8	19737779	.	A	G	5	2	7	0	0	7	0	0
8	19737782	.	C	G	5	2	7	0	0	7	0	0
8	19741629	.	C	T	2	0	2	0	0	2	0	0
8	19747748	.	C	A	2	1	3	0	0	3	0	0
8	20030855	.	G	A	7	3	10	0	0	10	0	0
8	20053642	.	A	G	1	2	3	0	0	3	0	0
8	20053647	.	C	T	1	2	3	0	0	3	0	0
8	20157920	.	G	T	6	2	8	0	0	8	0	0
8	20157964	.	A	G	7	3	10	0	0	10	0	0
8	20698008	.	A	T	12	5	17	4	1	22	0	0
8	20721217	.	A	G	9	2	11	0	0	11	0	0
8	20727130	.	G	A	23	9	32	0	0	32	0	0
8	25529870	.	C	T	5	4	9	0	1	10	0	0
8	26084735	.	T	C	1	2	3	0	0	3	0	0
8	26304438	.	T	C	3	2	5	0	0	5	0	0
8	26304442	.	T	C	4	1	5	0	0	5	0	0
8	35934896	.	A	T	13	1	14	0	0	14	0	0
8	35934898	.	A	C	13	1	14	0	0	14	0	0
8	39618334	.	C	A	7	3	10	0	0	10	0	0
8	41370848	.	A	G	12	6	18	0	0	18	0	0
8	42700052	.	A	G	0	1	1	0	1	2	0	0
8	42700280	.	T	C	0	3	3	0	0	3	0	0
8	59366732	.	C	T	5	2	7	0	1	8	0	0
8	59366734	.	C	T	6	2	8	0	0	8	0	0
8	70017218	.	C	G	1	5	6	0	0	6	0	0
8	70017232	.	G	A	1	5	6	0	0	6	0	0
8	70028756	.	G	A	0	0	0	0	1	1	0	0
8	70156937	.	T	C	1	2	3	0	0	3	0	0
8	70757737	.	C	T	9	2	11	0	1	12	0	0
8	70846188	.	T	C	2	1	3	0	1	4	0	0
8	71153126	.	T	C	7	8	15	0	7	22	0	0
8	71826346	.	A	G	9	3	12	0	0	12	0	0
8	71826392	.	A	G	6	4	10	0	0	10	0	0
8	72977426	.	A	G	16	23	39	0	0	39	0	0
8	84977744	.	T	C	4	3	7	0	0	7	0	0
8	85683657	.	A	C	3	2	5	0	0	5	0	0
8	88898496	.	A	G	18	4	22	0	0	22	0	0
8	89058442	.	T	C	4	2	6	0	0	6	0	0
8	94743910	.	T	C	10	2	12	0	1	13	0	0
8	94743960	.	T	C	5	3	8	0	0	8	0	0
8	95385481	.	C	A	9	0	9	0	1	10	0	0
8	95385487	.	G	A	8	1	9	0	1	10	0	0
8	107744427	.	A	G	2	4	6	0	0	6	0	0
8	107744841	.	A	G	18	4	22	0	0	22	0	0
8	107744848	.	A	G	3	17	20	0	0	20	0	0
8	110669007	.	T	A	7	2	9	0	1	10	0	0
8	111731423	.	T	C	17	5	22	0	0	22	0	0
8	111731758	.	T	C	18	7	25	0	0	25	0	0
8	122379478	.	T	C	12	1	13	0	0	13	0	0
8	122379480	.	T	G	11	1	12	0	1	13	0	0
8	123540896	.	A	G	1	1	2	0	0	2	0	0
8	124261954	.	A	G	4	3	7	0	0	7	0	0
8	125620613	.	T	C	11	9	20	0	2	22	0	0
8	125620618	.	T	C	8	13	21	0	0	21	0	0
8	125620861	.	T	C	20	12	32	0	1	33	0	0
8	125620923	.	T	C	7	31	38	0	0	38	0	0
8	125620929	.	T	C	12	16	28	0	1	29	0	0
9	3387716	.	A	G	12	4	16	0	0	16	0	0
9	4456006	.	T	C	0	2	2	0	0	2	0	0
9	7836792	.	T	C	5	2	7	0	0	7	0	0
9	20508072	.	A	G	2	3	5	0	1	6	0	0
9	20511950	.	A	G	4	4	8	0	0	8	0	0
9	20512443	.	A	G	7	2	9	0	0	9	0	0
9	20512914	.	A	G	5	2	7	0	0	7	0	0
9	20515384	.	A	G	4	2	6	0	0	6	0	0
9	21155767	.	G	A	10	2	12	0	0	12	0	0
9	21615439	.	A	G	1	3	4	0	0	4	0	0
9	21714180	.	A	G	3	0	3	0	0	3	0	0
9	43133655	.	C	T	9	2	11	0	0	11	0	0
9	43133659	.	A	C	6	2	8	0	3	11	0	0
9	44204075	.	T	C	12	3	15	0	0	15	0	0
9	44206126	.	T	C	12	3	15	0	1	16	0	0
9	44206135	.	T	C	8	6	14	0	0	14	0	0
9	44322493	.	T	C	1	2	3	0	0	3	0	0
9	44836963	.	T	A	16	4	20	0	3	23	0	0
9	45747294	.	C	T	0	4	4	0	0	4	0	0
9	49413448	.	C	T	2	3	5	0	0	5	0	0
9	49414908	.	C	T	27	8	35	0	6	41	0	0
9	49414913	.	C	T	30	2	32	0	7	39	0	0
9	49415404	.	G	A	4	3	7	0	1	8	0	0
9	49415411	.	G	A	4	1	5	0	3	8	0	0
9	53528681	.	G	A	3	3	6	0	3	9	0	0
9	53528684	.	T	A	4	0	4	0	4	8	0	0
9	57658827	.	C	T	9	3	12	0	0	12	0	0
9	65253476	.	A	G	7	2	9	0	0	9	0	0
9	65947750	.	G	T	1	5	6	0	1	7	0	0
9	66280460	.	A	G	1	2	3	0	0	3	0	0
9	67892060	.	C	T	10	6	16	0	0	16	0	0
9	67892066	.	C	T	9	5	14	0	2	16	0	0
9	69923101	.	A	G	3	4	7	0	0	7	0	0
9	72117135	.	A	G	1	2	3	0	0	3	0	0
9	72366578	.	T	C	1	2	3	0	0	3	0	0
9	72382377	.	T	C	1	2	3	0	0	3	0	0
9	75411333	.	A	G	2	2	4	0	0	4	0	0
9	78076674	.	A	G	10	3	13	0	1	14	0	0
9	89794102	.	T	C	3	1	4	0	12	16	0	0
9	89794108	.	G	C	4	6	10	0	6	16	0	0
9	89990745	.	T	C	1	2	3	0	0	3	0	0
9	95939293	.	A	G	15	6	21	0	0	21	0	0
9	96188530	.	A	G	2	2	4	0	0	4	0	0
9	96777818	.	T	C	5	0	5	0	0	5	0	0
9	96981397	.	T	C	1	2	3	0	0	3	0	0
9	98871454	.	A	G	2	2	4	0	0	4	0	0
9	103062470	.	C	A	3	5	8	0	0	8	0	0
9	103062472	.	C	A	3	5	8	0	0	8	0	0
9	106117064	.	T	C	1	3	4	0	0	4	0	0
9	108215047	.	T	G	1	4	5	0	5	11	1	0
9	108326717	.	A	G	2	0	2	0	3	5	0	0
9	110086210	.	A	G	6	2	8	0	0	8	0	0
9	114425843	.	T	C	3	5	8	0	0	8	0	0
9	116407082	.	C	T	1	1	2	0	0	2	0	0
9	116407088	.	C	T	1	1	2	0	0	2	0	0
9	118754231	.	C	G	11	3	14	0	0	14	0	0
9	123525510	.	G	A	3	3	6	0	4	10	0	0
9	123528785	.	A	G	19	6	25	0	0	25	0	0
9	124033039	.	T	G	3	2	5	0	0	5	0	0
9	124033057	.	G	T	4	2	6	0	0	6	0	0
9	124034058	.	T	G	6	2	8	1	0	9	0	0
9	124034094	.	A	G	6	3	9	0	1	10	0	0
X	7774376	.	A	G	6	2	8	0	0	8	0	0
X	17422820	.	A	G	4	2	6	0	0	6	0	0
X	37697716	.	A	G	8	2	10	0	1	11	0	0
X	40743129	.	A	G	0	10	10	0	0	10	0	0
X	40743165	.	A	G	6	4	10	0	1	11	0	0
X	55695874	.	A	G	2	3	5	0	1	6	0	0
X	55695894	.	A	G	1	1	2	0	1	3	0	0
X	60226851	.	T	C	8	8	16	0	1	17	0	0
X	60231705	.	A	G	15	10	25	0	0	25	0	0
X	69388256	.	T	C	6	4	10	0	0	10	0	0
X	69388288	.	T	C	130	20	150	0	3	153	0	0
X	73270255	.	T	C	3	6	9	0	0	9	0	0
X	73270468	.	T	C	1	13	14	0	2	16	0	0
X	73328516	.	A	G	2	4	6	0	0	6	0	0
X	73328787	.	A	G	3	3	6	0	0	6	0	0
X	80866141	.	T	C	0	2	2	8	0	10	0	0
X	102620114	.	T	C	8	4	12	0	0	12	0	0
X	102620158	.	T	C	4	7	11	0	0	11	0	0
X	102620159	.	T	C	3	7	10	0	1	11	0	0
X	102623385	.	T	C	10	2	12	0	0	12	0	0
X	119819641	.	C	T	5	2	7	0	1	8	0	0
X	133490062	.	T	C	6	4	10	0	0	10	0	0
X	133490096	.	T	C	4	3	7	0	0	7	0	0
X	133490134	.	T	C	3	4	7	0	0	7	0	0
X	133490145	.	T	C	4	5	9	0	1	10	0	0
X	138844282	.	T	C	5	2	7	0	0	7	0	0
X	145978689	.	A	G	52	11	63	0	0	63	0	0
X	149766871	.	T	C	12	11	23	0	9	32	0	0
X	149767614	.	T	C	66	57	123	0	7	130	0	0
X	149768450	.	T	C	141	54	195	0	1	196	0	0
X	162761028	.	T	C	5	3	8	0	0	8	0	0
X	164972992	.	A	G	10	4	14	0	0	14	0	0
X	168759395	.	C	A	1	2	3	0	0	3	0	0
Y	1016394	.	A	G	9	14	23	0	5	28	0	0
Y	1016396	.	A	G	21	6	27	0	1	28	0	0
Y	1048551	.	A	G	5	5	10	0	0	10	0	0
Y	1048565	.	A	G	6	4	10	0	0	10	0	0
