contig	position	variantID	refAllele	altAllele	refCount	altCount	totalCount	lowMAPQDepth	lowBaseQDepth	rawDepth	otherBases	improperPairs
1	4980146	.	G	A	14	5	19	0	9	28	0	0
1	11671340	.	A	G	11	6	17	0	0	17	0	0
1	12636422	.	C	T	0	1	1	0	0	1	0	0
1	15782517	.	C	T	5	2	7	0	0	7	0	0
1	22031785	.	T	C	5	10	15	0	0	15	0	0
1	22031965	.	T	C	12	3	15	0	0	15	0	0
1	36405381	.	T	C	1	2	3	0	0	3	0	0
1	37448671	.	G	T	0	4	4	0	0	4	0	0
1	39590795	.	G	T	4	2	6	0	3	9	0	0
1	39590799	.	G	T	5	2	7	0	2	9	0	0
1	39695983	.	A	G	2	2	4	0	0	4	0	0
1	39696041	.	A	G	4	2	6	0	0	6	0	0
1	43131596	.	C	G	6	10	16	0	0	16	0	0
1	57982191	.	A	C	3	5	8	0	0	8	0	0
1	59756950	.	A	G	9	2	11	0	1	12	0	0
1	59756998	.	A	G	9	3	12	0	0	12	0	0
1	59913367	.	A	G	73	20	93	0	7	100	0	0
1	60190327	.	A	C	7	2	9	0	2	11	0	0
1	60191150	.	A	G	3	3	6	0	1	7	0	0
1	60517747	.	A	G	37	30	67	0	8	75	0	0
1	62836150	.	G	A	3	2	5	0	1	6	0	0
1	63156443	.	A	G	4	2	6	0	0	6	0	0
1	66711873	.	A	G	73	29	102	0	5	107	0	0
1	74474817	.	C	T	8	2	10	0	0	10	0	0
1	74720979	.	T	C	2	0	2	0	0	2	0	0
1	75398649	.	A	G	20	7	27	0	0	27	0	0
1	75398708	.	A	G	2	22	24	0	2	26	0	0
1	79681738	.	G	T	0	2	2	0	0	2	0	0
1	79681745	.	G	T	0	2	2	0	0	2	0	0
1	86275458	.	T	C	29	4	33	0	0	33	0	0
1	86275650	.	T	C	26	6	32	0	1	33	0	0
1	86276528	.	T	C	18	6	24	0	0	24	0	0
1	86836917	.	T	C	0	2	2	8	0	10	0	0
1	88187259	.	T	C	4	2	6	0	1	7	0	0
1	88188057	.	A	C	1	10	11	0	0	11	0	0
1	88188277	.	C	G	3	3	6	0	0	6	0	0
1	88188360	.	T	G	1	7	8	0	0	8	0	0
1	88188362	.	C	G	1	7	8	0	0	8	0	0
1	88188444	.	G	C	1	5	6	0	0	6	0	0
1	88189006	.	G	A	1	2	3	0	0	3	0	0
1	88189435	.	G	C	4	2	6	0	0	6	0	0
1	88189462	.	G	A	3	2	5	0	0	5	0	0
1	88189611	.	A	G	4	2	6	0	0	6	0	0
1	88189685	.	C	A	2	3	5	0	0	5	0	0
1	88190661	.	G	C	2	4	6	0	0	6	0	0
1	88190921	.	C	T	0	10	10	0	0	10	0	0
1	88191018	.	A	T	2	9	11	0	0	11	0	0
1	88191035	.	T	A	2	5	7	0	0	7	0	0
1	88191237	.	A	C	11	42	53	0	8	61	0	0
1	88191320	.	C	T	7	42	49	0	1	50	0	0
1	88191706	.	G	A	43	13	56	0	2	58	0	0
1	88191710	.	T	C	16	41	57	0	0	57	0	0
1	88191744	.	C	A	39	15	54	0	0	54	0	0
1	88191864	.	G	T	66	18	84	0	3	87	0	0
1	88192008	.	C	T	62	11	73	0	8	81	0	0
1	88192048	.	G	C	12	38	50	0	1	51	0	0
1	88192098	.	G	A	53	15	68	0	1	69	0	0
1	88192180	.	G	T	73	18	91	0	0	91	0	0
1	88192184	.	T	A	70	17	87	0	2	89	0	0
1	88192243	.	A	G	12	38	50	0	0	50	0	0
1	88192700	.	G	A	14	23	37	0	1	38	0	0
1	88192756	.	G	A	15	45	60	0	1	61	0	0
1	88193031	.	C	G	8	22	30	0	0	30	0	0
1	88193194	.	C	T	4	8	12	0	0	12	0	0
1	88193292	.	T	A	0	2	2	6	0	8	0	0
1	88193614	.	C	G	12	2	14	0	0	14	0	0
1	88193917	.	G	A	11	16	27	0	1	28	0	0
1	88194314	.	C	A	42	6	48	1	0	49	0	0
1	88197053	.	T	C	4	0	4	0	1	5	0	0
1	88197991	.	A	G	4	23	27	0	0	27	0	0
1	88197996	.	C	T	2	24	26	0	1	27	0	0
1	88200452	.	A	G	4	17	21	0	4	25	0	0
1	88200832	.	C	T	5	15	20	0	0	20	0	0
1	88202772	.	A	T	2	0	2	0	1	3	0	0
1	88205197	.	A	G	0	3	3	0	0	3	0	0
1	88205247	.	A	G	0	0	0	0	1	1	0	0
1	88205286	.	A	T	2	2	4	0	1	5	0	0
1	91860479	.	C	T	5	2	7	0	0	7	0	0
1	91860480	.	G	T	5	2	7	0	0	7	0	0
1	93299316	.	A	G	17	4	21	0	1	22	0	0
1	95426538	.	A	G	0	3	3	2	0	5	0	0
1	118225697	.	T	C	5	3	8	0	1	9	0	0
1	119398801	.	G	A	2	1	3	0	2	5	0	0
1	131953439	.	T	C	16	9	25	0	1	26	0	0
1	133065748	.	A	G	41	8	49	0	0	49	0	0
1	133629832	.	T	C	1	2	3	0	0	3	0	0
1	133629833	.	T	C	1	2	3	0	0	3	0	0
1	152651318	.	T	C	5	2	7	0	0	7	0	0
1	153094863	.	C	G	5	4	9	0	4	13	0	0
1	153636565	.	G	A	1	0	1	0	2	3	0	0
1	156194054	.	C	A	9	3	12	0	1	13	0	0
1	156255601	.	T	C	6	2	8	0	0	8	0	0
1	159759023	.	G	A	11	12	23	0	13	36	0	0
1	171151897	.	T	C	1	2	3	0	0	3	0	0
1	171716713	.	T	C	2	1	3	0	1	4	0	0
1	178779812	.	T	C	13	3	16	0	0	16	0	0
1	178779916	.	T	C	8	6	14	0	0	14	0	0
1	178780229	.	T	C	11	10	21	0	1	22	0	0
1	180924020	.	T	C	24	9	33	0	0	33	0	0
1	182129041	.	T	C	7	2	9	0	0	9	0	0
1	183190594	.	A	G	15	6	21	0	0	21	0	0
1	187081766	.	T	C	7	3	10	0	0	10	0	0
10	7524278	.	T	C	5	1	6	0	0	6	0	0
10	18000875	.	A	G	9	2	11	0	0	11	0	0
10	29104018	.	G	T	6	5	11	0	0	11	0	0
10	29104019	.	G	T	6	4	10	0	1	11	0	0
10	29104091	.	A	G	23	4	27	0	2	29	0	0
10	33791335	.	A	G	9	2	11	0	0	11	0	0
10	33864897	.	T	C	8	2	10	0	1	11	0	0
10	33868452	.	T	C	4	1	5	0	0	5	0	0
10	33868473	.	T	C	6	5	11	0	1	12	0	0
10	33869368	.	T	C	11	2	13	0	1	14	0	0
10	41407039	.	T	A	1	4	5	0	0	5	0	0
10	41407040	.	C	A	1	4	5	0	0	5	0	0
10	43400614	.	A	C	1	2	3	0	0	3	0	0
10	43414676	.	T	C	1	2	3	0	0	3	0	0
10	45752162	.	G	A	7	5	12	0	1	13	0	0
10	49118584	.	T	C	4	10	14	0	0	14	0	0
10	49118640	.	T	C	14	8	22	0	1	23	0	0
10	49120426	.	T	C	0	7	7	0	0	7	0	0
10	49148885	.	T	C	4	23	27	0	0	27	0	0
10	62645542	.	T	C	2	4	6	0	0	6	0	0
10	73038538	.	A	G	0	2	2	0	0	2	0	0
10	80522269	.	T	C	9	3	12	0	0	12	0	0
10	82486401	.	T	C	19	3	22	0	0	22	0	0
10	82486613	.	T	C	9	5	14	0	0	14	0	0
10	82586061	.	C	T	33	10	43	0	3	46	0	0
10	84363211	.	T	G	13	5	18	0	11	29	0	0
10	88306343	.	T	C	14	4	18	0	1	19	0	0
10	93801926	.	T	C	4	4	8	0	0	8	0	0
10	93978692	.	A	T	1	1	2	0	2	4	0	0
10	94057224	.	A	G	19	9	28	0	0	28	0	0
10	99932788	.	A	C	9	3	12	0	5	17	0	0
10	99932794	.	A	C	8	7	15	0	2	17	0	0
10	112761338	.	C	T	3	3	6	0	1	7	0	0
10	115125374	.	G	A	14	3	17	0	1	18	0	0
10	126903751	.	T	C	64	16	80	0	0	81	1	0
10	127581290	.	A	G	3	2	5	0	0	5	0	0
10	127962888	.	T	C	8	6	14	0	9	23	0	0
10	128032727	.	A	G	3	1	4	0	0	4	0	0
10	128032764	.	A	G	3	2	5	0	0	5	0	0
10	128481763	.	C	T	4	2	6	0	0	6	0	0
11	3077575	.	C	A	5	2	7	31	1	39	0	0
11	3152967	.	C	T	3	1	4	0	0	4	0	0
11	3407568	.	A	G	9	2	11	0	0	11	0	0
11	3407590	.	A	G	7	3	10	0	0	10	0	0
11	3850994	.	A	G	14	7	21	0	0	21	0	0
11	4092790	.	T	C	21	10	31	0	0	31	0	0
11	19972917	.	A	T	8	2	10	0	9	19	0	0
11	20178606	.	T	C	19	7	26	0	0	26	0	0
11	43572939	.	A	G	4	3	7	0	0	7	0	0
11	43573028	.	A	G	5	3	8	0	0	8	0	0
11	45821425	.	T	C	16	4	20	0	0	20	0	0
11	46163470	.	T	C	51	249	300	0	3	303	0	0
11	57900067	.	C	T	3	1	4	0	1	5	0	0
11	59049909	.	A	G	7	2	9	0	0	9	0	0
11	59347027	.	A	G	20	16	36	0	1	37	0	0
11	59347029	.	A	G	24	11	35	0	2	37	0	0
11	59347072	.	A	G	17	5	22	0	1	23	0	0
11	59349201	.	A	G	17	6	23	0	1	24	0	0
11	59349204	.	A	G	18	8	26	0	0	26	0	0
11	59401881	.	A	G	4	3	7	0	0	7	0	0
11	62032236	.	A	G	1	2	3	0	0	3	0	0
11	69514179	.	A	G	4	2	6	0	0	6	0	0
11	69674128	.	A	G	12	5	17	0	0	17	0	0
11	69674129	.	A	G	14	3	17	0	0	17	0	0
11	69922901	.	A	G	4	4	8	0	0	8	0	0
11	69922950	.	A	G	4	2	6	0	0	6	0	0
11	69925824	.	A	G	2	3	5	0	0	5	0	0
11	69926813	.	A	G	4	5	9	0	0	9	0	0
11	69937302	.	A	G	9	4	13	0	0	13	0	0
11	69937304	.	A	G	11	2	13	0	0	13	0	0
11	70104900	.	A	C	1	2	3	0	3	6	0	0
11	70500705	.	C	T	14	4	18	2	0	20	0	0
11	70500706	.	G	A	14	4	18	2	0	20	0	0
11	74747553	.	T	C	0	3	3	0	0	3	0	0
11	75067170	.	T	C	25	15	40	0	1	41	0	0
11	75067258	.	T	C	25	5	30	0	0	30	0	0
11	75068297	.	T	C	27	6	33	0	1	34	0	0
11	75343789	.	A	T	11	2	13	0	1	14	0	0
11	77426880	.	T	C	44	12	56	0	1	57	0	0
11	78186104	.	A	G	5	3	8	0	1	9	0	0
11	78187480	.	A	G	2	2	4	0	0	4	0	0
11	78388363	.	G	A	6	4	10	0	3	13	0	0
11	78588120	.	T	C	13	6	19	0	0	19	0	0
11	78588128	.	A	C	12	3	15	0	1	16	0	0
11	80371357	.	G	A	99	48	147	0	29	176	0	0
11	82853392	.	A	G	1	2	3	0	0	3	0	0
11	82853481	.	A	G	2	2	4	0	0	4	0	0
11	85082181	.	C	T	11	7	18	0	6	24	0	0
11	85082185	.	C	T	9	0	9	0	7	16	0	0
11	87014103	.	A	G	14	4	18	0	2	20	0	0
11	87014114	.	A	G	13	5	18	0	0	18	0	0
11	88083921	.	T	C	7	4	11	0	1	12	0	0
11	88927208	.	T	C	18	9	27	0	1	28	0	0
11	94299330	.	C	T	5	0	5	0	3	8	0	0
11	94299332	.	C	T	5	3	8	0	0	8	0	0
11	94431318	.	T	C	6	3	9	0	0	9	0	0
11	94431472	.	T	C	10	2	12	0	0	12	0	0
11	94432839	.	T	C	9	5	14	0	1	15	0	0
11	94432859	.	T	C	14	4	18	0	0	18	0	0
11	95282478	.	T	A	9	8	17	0	4	21	0	0
11	95962333	.	T	C	4	2	6	0	0	6	0	0
11	95962468	.	T	C	5	3	8	0	0	8	0	0
11	96855788	.	A	G	2	6	8	0	0	8	0	0
11	97285031	.	A	C	7	6	13	0	1	14	0	0
11	97535375	.	T	C	8	3	11	0	0	11	0	0
11	97535690	.	T	C	11	4	15	0	1	16	0	0
11	97978020	.	A	G	1	5	6	0	0	6	0	0
11	98044426	.	C	A	4	2	6	0	0	6	0	0
11	98775888	.	T	C	9	3	12	0	3	15	0	0
11	98794177	.	G	A	13	11	24	0	5	29	0	0
11	100488792	.	T	C	9	7	16	0	0	16	0	0
11	101089107	.	T	C	14	3	17	0	0	17	0	0
11	101089126	.	T	C	4	9	13	0	0	13	0	0
11	101089557	.	T	C	15	4	19	0	0	19	0	0
11	101089729	.	T	C	15	5	20	0	0	20	0	0
11	101089734	.	T	C	11	9	20	0	0	20	0	0
11	101089802	.	T	C	10	7	17	0	1	18	0	0
11	104220901	.	G	A	18	5	23	0	0	23	0	0
11	104220906	.	G	A	7	4	11	0	3	14	0	0
11	105879986	.	A	C	3	2	5	0	3	8	0	0
11	105879992	.	A	C	2	2	4	0	1	5	0	0
11	106926353	.	C	T	3	2	5	0	0	5	0	0
11	115692186	.	T	G	8	3	11	0	1	12	0	0
11	116013650	.	T	C	2	2	4	0	0	4	0	0
11	116245085	.	T	C	3	3	6	0	0	6	0	0
11	116303813	.	T	C	3	2	5	0	0	5	0	0
11	116471963	.	T	C	9	26	35	0	3	38	0	0
11	116698696	.	T	G	2	1	3	0	1	4	0	0
12	3454248	.	A	G	15	47	62	0	9	71	0	0
12	8547666	.	A	T	3	4	7	0	0	7	0	0
12	17479686	.	A	G	17	3	20	0	1	21	0	0
12	17479809	.	A	G	7	15	22	0	0	22	0	0
12	33183407	.	C	T	2	1	3	0	1	4	0	0
12	46747117	.	T	C	34	15	49	0	0	49	0	0
12	54718540	.	T	C	21	6	27	0	1	28	0	0
12	54719070	.	T	C	26	13	39	0	0	39	0	0
12	54719142	.	T	C	35	7	42	0	1	43	0	0
12	65099888	.	T	C	1	1	2	0	2	4	0	0
12	65113982	.	T	C	4	2	6	0	0	6	0	0
12	69244102	.	A	G	21	9	30	0	1	31	0	0
12	69347175	.	A	G	2	2	4	0	0	4	0	0
12	71041403	.	A	G	4	36	40	0	1	41	0	0
12	71041903	.	A	G	3	26	29	0	1	30	0	0
12	71041906	.	A	G	23	7	30	0	0	30	0	0
12	71041945	.	A	G	29	5	34	0	0	34	0	0
12	71180745	.	T	C	5	5	10	0	0	10	0	0
12	71998702	.	A	C	11	5	16	0	1	17	0	0
12	71998705	.	A	C	11	3	14	0	2	16	0	0
12	72955837	.	T	C	9	7	16	0	0	16	0	0
12	72955848	.	T	C	6	5	11	0	0	11	0	0
12	75678133	.	A	G	2	5	7	0	0	7	0	0
12	78731515	.	T	A	7	2	9	0	4	13	0	0
12	78887986	.	T	C	7	2	9	0	0	9	0	0
12	80769436	.	A	G	2	5	7	0	0	7	0	0
12	81775557	.	T	C	3	0	3	0	0	3	0	0
12	84092114	.	A	G	4	2	6	0	0	6	0	0
12	84197105	.	A	C	5	2	7	0	2	9	0	0
12	84197111	.	A	C	5	4	9	0	1	10	0	0
12	84724302	.	T	G	8	5	13	0	11	24	0	0
12	84809097	.	T	C	1	3	4	0	0	4	0	0
12	84969484	.	T	C	3	2	5	0	0	5	0	0
12	84969788	.	T	C	1	2	3	0	0	3	0	0
12	85388469	.	A	C	4	2	6	0	1	7	0	0
12	85388475	.	G	C	4	3	7	0	2	9	0	0
12	86726722	.	A	C	3	7	10	0	0	10	0	0
12	86726725	.	T	C	3	6	9	0	0	9	0	0
12	87467472	.	G	A	1	3	4	0	0	4	0	0
12	91605436	.	T	C	9	2	11	0	0	11	0	0
12	98713722	.	C	T	1	1	2	0	0	2	0	0
12	98713724	.	C	T	1	0	1	0	1	2	0	0
12	98761274	.	T	C	7	2	9	0	0	9	0	0
12	100837974	.	A	G	11	2	13	0	0	13	0	0
12	100843647	.	T	C	9	2	11	0	0	11	0	0
12	101886131	.	T	C	14	5	19	0	0	19	0	0
12	103166090	.	A	G	3	1	4	0	2	6	0	0
12	103381641	.	C	T	2	2	4	0	0	4	0	0
12	103381643	.	G	T	2	1	3	0	1	4	0	0
12	107877223	.	A	C	9	2	11	0	6	17	0	0
12	108171831	.	C	G	4	6	10	0	1	11	0	0
12	108993691	.	A	G	15	4	19	0	1	20	0	0
12	109602157	.	C	A	5	1	6	0	0	6	0	0
12	109706996	.	A	G	3	2	5	0	0	5	0	0
13	14176103	.	T	C	3	4	7	0	0	7	0	0
13	14225628	.	T	C	33	10	43	0	0	43	0	0
13	15989053	.	T	C	0	2	2	0	1	3	0	0
13	17889143	.	C	T	5	2	7	0	0	7	0	0
13	17978707	.	T	C	10	2	12	0	0	12	0	0
13	17978887	.	T	C	4	2	6	0	0	6	0	0
13	17979133	.	T	C	8	3	11	0	1	12	0	0
13	21571267	.	G	T	1	2	3	0	1	4	0	0
13	21571270	.	C	T	1	2	3	0	1	4	0	0
13	21574169	.	T	C	12	4	16	0	0	16	0	0
13	21574188	.	T	C	10	2	12	0	0	12	0	0
13	21576493	.	T	C	5	2	7	0	0	7	0	0
13	24999535	.	A	G	2	4	6	0	0	6	0	0
13	29133061	.	G	T	1	4	5	0	1	6	0	0
13	55745486	.	G	A	6	3	9	0	2	11	0	0
13	55745493	.	G	A	4	1	5	0	2	7	0	0
13	64438124	.	T	C	11	3	14	0	0	14	0	0
13	67621265	.	T	C	5	3	8	0	1	9	0	0
13	67621455	.	T	C	8	2	10	0	0	10	0	0
13	67806988	.	T	C	3	2	5	0	0	5	0	0
13	67807053	.	T	C	1	5	6	0	0	6	0	0
13	68768165	.	C	T	0	2	2	0	0	2	0	0
13	74753337	.	A	G	4	2	6	0	0	6	0	0
13	78347093	.	A	C	2	2	4	0	4	8	0	0
13	80309695	.	A	C	0	2	2	2	0	4	0	0
13	81031735	.	C	T	13	0	13	0	3	16	0	0
13	89805164	.	T	A	5	1	6	0	0	6	0	0
13	89805165	.	A	T	5	1	6	0	0	6	0	0
13	97594875	.	T	G	0	3	3	0	0	3	0	0
13	104630430	.	G	A	3	1	4	0	0	4	0	0
13	111884837	.	G	A	1	2	3	0	0	3	0	0
13	119625401	.	G	T	14	14	28	0	0	28	0	0
14	9647289	.	A	G	67	16	83	0	2	85	0	0
14	10058181	.	A	G	47	12	59	0	3	62	0	0
14	21846832	.	A	G	14	42	56	0	2	58	0	0
14	21846833	.	A	G	47	11	58	0	0	58	0	0
14	21847779	.	A	G	91	26	117	0	3	120	0	0
14	26381874	.	T	C	6	2	8	0	0	8	0	0
14	26382413	.	T	C	5	3	8	0	0	8	0	0
14	26643098	.	T	C	15	4	19	0	2	21	0	0
14	29788070	.	T	C	12	4	16	0	0	16	0	0
14	29788078	.	T	C	7	7	14	0	0	14	0	0
14	30698016	.	A	G	1	2	3	0	0	3	0	0
14	30861568	.	A	G	5	0	5	0	0	5	0	0
14	31095923	.	C	T	14	4	18	0	6	24	0	0
14	31095927	.	C	T	15	0	15	0	7	22	0	0
14	31228237	.	A	G	3	2	5	0	0	5	0	0
14	31422583	.	T	C	28	15	43	0	0	43	0	0
14	31422586	.	T	C	33	8	41	0	0	41	0	0
14	31422619	.	T	C	33	21	54	0	0	54	0	0
14	31422622	.	T	C	45	7	52	0	1	53	0	0
14	31423408	.	T	C	48	7	55	0	0	55	0	0
14	32018582	.	A	G	27	10	37	0	2	39	0	0
14	47558234	.	A	G	8	4	12	0	1	13	0	0
14	48646502	.	T	C	0	2	2	0	0	2	0	0
14	49918876	.	A	G	10	3	13	0	0	13	0	0
14	51013458	.	T	C	11	2	13	0	0	13	0	0
14	51014498	.	T	C	14	3	17	0	0	17	0	0
14	51109987	.	A	G	4	3	7	0	0	7	0	0
14	54744923	.	C	T	14	7	21	0	1	23	1	0
14	54744924	.	G	T	14	6	20	0	3	23	0	0
14	54928195	.	G	A	1	2	3	0	0	3	0	0
14	60451314	.	T	C	3	2	5	0	0	5	0	0
14	61602660	.	A	T	2	2	4	0	0	4	0	0
14	62930650	.	C	T	2	1	3	0	1	4	0	0
14	65434640	.	T	C	35	19	54	0	0	54	0	0
14	67253167	.	A	T	19	4	23	0	14	37	0	0
14	69481558	.	A	G	11	2	13	0	0	13	0	0
14	75957159	.	T	C	14	4	18	0	1	19	0	0
14	79698092	.	T	C	14	3	17	0	0	17	0	0
14	103584115	.	T	C	19	15	34	0	0	34	0	0
14	119326620	.	G	T	5	1	6	0	1	7	0	0
14	119326621	.	A	T	5	1	6	0	1	7	0	0
14	121273016	.	A	G	7	7	14	0	0	14	0	0
14	124212470	.	G	A	10	3	13	0	2	15	0	0
15	5150549	.	A	G	0	3	3	0	0	3	0	0
15	8187674	.	A	G	7	7	14	0	0	14	0	0
15	8188973	.	A	G	2	6	8	0	2	10	0	0
15	27732222	.	G	T	7	3	10	0	3	13	0	0
15	54616316	.	G	A	2	2	4	0	3	7	0	0
15	55118295	.	A	G	17	4	21	0	0	21	0	0
15	55118692	.	A	G	8	7	15	0	0	15	0	0
15	66158075	.	T	C	9	5	14	0	1	15	0	0
15	66483401	.	T	C	2	1	3	0	1	4	0	0
15	68965365	.	G	A	3	2	5	0	0	5	0	0
15	68973014	.	C	A	2	2	4	0	2	6	0	0
15	76248265	.	A	G	2	2	4	0	0	4	0	0
15	76426241	.	C	T	4	2	6	0	0	6	0	0
15	76601407	.	A	G	1	2	3	0	0	3	0	0
15	78900113	.	T	C	4	5	9	0	0	9	0	0
15	79791742	.	A	G	2	2	4	0	0	4	0	0
15	79791748	.	A	G	1	3	4	0	0	4	0	0
15	80816550	.	A	G	4	5	9	0	0	9	0	0
15	81339166	.	A	G	10	3	13	0	0	13	0	0
15	81341097	.	A	G	5	5	10	0	2	12	0	0
15	81341105	.	A	G	5	4	9	0	1	10	0	0
15	81799307	.	G	A	41	12	53	0	12	65	0	0
15	82237299	.	C	T	6	2	8	0	0	8	0	0
15	83239089	.	T	C	5	1	6	0	0	6	0	0
15	83542303	.	T	C	2	2	4	0	0	4	0	0
15	84198527	.	A	C	12	6	18	0	2	20	0	0
15	84198533	.	A	C	10	2	12	0	4	16	0	0
15	89357811	.	G	A	3	2	5	0	1	6	0	0
15	93172792	.	T	A	3	0	3	0	0	3	0	0
15	93388677	.	C	G	11	3	14	0	6	21	1	0
15	93388679	.	A	G	11	3	14	0	7	21	0	0
15	98634993	.	T	C	25	40	65	0	2	67	0	0
15	98731431	.	T	C	27	7	34	0	0	34	0	0
15	98932415	.	C	T	0	2	2	2	0	4	0	0
15	99142536	.	T	C	3	2	5	0	0	5	0	0
15	99626049	.	A	G	10	4	14	0	0	14	0	0
15	99626051	.	A	G	7	7	14	0	0	14	0	0
15	99626091	.	A	G	10	2	12	0	0	12	0	0
15	99627262	.	A	G	3	5	8	0	0	8	0	0
16	3680985	.	T	C	20	4	24	0	0	24	0	0
16	4138530	.	T	G	0	2	2	42	0	44	0	0
16	4844012	.	T	C	1	2	3	0	0	3	0	0
16	13520445	.	A	G	24	15	39	0	0	39	0	0
16	13520501	.	A	G	13	3	16	0	1	17	0	0
16	13650446	.	A	G	7	2	9	0	0	9	0	0
16	13650452	.	A	G	2	6	8	0	0	8	0	0
16	13651794	.	G	T	7	5	12	0	1	13	0	0
16	13651795	.	G	T	6	5	11	0	2	13	0	0
16	13767397	.	A	G	18	3	21	0	0	21	0	0
16	13927103	.	G	C	4	0	4	0	9	13	0	0
16	16844922	.	A	G	4	3	7	0	0	7	0	0
16	16844952	.	A	G	2	3	5	0	0	5	0	0
16	16866848	.	A	G	1	3	4	0	0	4	0	0
16	17321752	.	A	G	7	4	11	0	0	11	0	0
16	18653678	.	A	G	37	13	50	0	0	50	0	0
16	19942489	.	A	G	34	10	44	0	1	45	0	0
16	19942498	.	A	G	25	18	43	0	0	43	0	0
16	20363153	.	A	G	6	5	11	0	0	11	0	0
16	20363189	.	A	G	7	6	13	0	0	13	0	0
16	29140475	.	A	G	3	0	3	0	0	3	0	0
16	30330773	.	T	C	14	4	18	0	0	18	0	0
16	32118665	.	A	G	17	7	24	0	0	24	0	0
16	32119150	.	A	G	25	13	38	0	0	38	0	0
16	32209076	.	C	T	8	2	10	0	3	13	0	0
16	35747215	.	T	C	2	2	4	0	0	4	0	0
16	43691361	.	T	C	2	4	6	0	0	6	0	0
16	44042800	.	C	T	7	2	9	0	2	11	0	0
16	62537826	.	G	A	2	0	2	0	0	2	0	0
16	62615375	.	A	T	4	2	6	0	0	6	0	0
16	63365868	.	G	A	6	2	8	0	0	8	0	0
16	75398743	.	A	G	2	3	5	0	0	5	0	0
16	81393075	.	C	T	5	2	7	0	0	7	0	0
16	85599230	.	G	A	11	2	13	0	0	13	0	0
16	87230813	.	T	C	10	5	15	0	0	15	0	0
16	87737431	.	T	C	0	1	1	0	0	1	0	0
16	91287619	.	A	G	4	1	5	0	1	6	0	0
16	91452503	.	A	G	110	18	128	0	2	130	0	0
16	97658408	.	T	C	2	3	5	0	0	5	0	0
17	3127588	.	T	G	4	0	4	0	0	4	0	0
17	6173357	.	A	G	5	4	9	0	0	9	0	0
17	6320824	.	C	G	1	0	1	0	0	1	0	0
17	6320836	.	G	A	1	0	1	0	0	1	0	0
17	9539467	.	T	A	0	3	3	0	0	3	0	0
17	13238450	.	A	G	8	3	11	0	0	11	0	0
17	15695826	.	T	C	1	3	4	0	0	4	0	0
17	15741073	.	A	G	4	2	6	0	0	6	0	0
17	15741583	.	A	G	4	4	8	0	0	8	0	0
17	15742482	.	A	G	2	4	6	0	0	6	0	0
17	15742489	.	A	G	4	3	7	0	1	8	0	0
17	17565922	.	T	C	6	2	8	1	0	9	0	0
17	24395428	.	T	C	27	15	42	0	0	42	0	0
17	24395462	.	T	C	40	14	54	0	0	54	0	0
17	24395463	.	T	C	35	19	54	0	0	54	0	0
17	24635698	.	A	G	4	3	7	0	1	8	0	0
17	24635786	.	A	G	7	2	9	0	0	9	0	0
17	24941898	.	T	C	8	2	10	0	0	10	0	0
17	26875714	.	T	G	4	3	7	0	3	10	0	0
17	26916583	.	A	G	4	2	6	0	0	6	0	0
17	27814786	.	T	C	2	2	4	0	0	4	0	0
17	29259605	.	C	T	8	7	15	0	2	17	0	0
17	29521001	.	A	G	8	7	15	0	1	16	0	0
17	29521045	.	A	G	13	2	15	0	0	15	0	0
17	33015547	.	T	C	8	3	11	0	0	11	0	0
17	33552004	.	T	C	13	4	17	0	1	18	0	0
17	33867517	.	T	C	6	3	9	0	1	10	0	0
17	33906234	.	T	C	11	4	15	0	0	15	0	0
17	34147531	.	A	G	17	4	21	0	1	22	0	0
17	36168626	.	A	G	8	7	15	0	0	15	0	0
17	36580955	.	T	C	3	2	5	0	0	5	0	0
17	40158498	.	T	C	3619	5350	8969	0	155	9554	430	0
17	40159543	.	T	C	33	205	238	0	2	240	0	0
17	45973875	.	T	C	13	41	54	0	8	62	0	0
17	46985479	.	G	T	3	3	6	0	0	6	0	0
17	47085856	.	T	C	13	8	21	0	1	22	0	0
17	47085857	.	T	C	15	7	22	0	0	22	0	0
17	47996812	.	T	C	1	1	2	0	1	3	0	0
17	52166231	.	A	G	3	5	8	0	0	8	0	0
17	52166256	.	A	G	3	3	6	0	1	7	0	0
17	72164907	.	A	T	4	1	5	0	2	7	0	0
17	72164908	.	A	T	4	0	4	0	4	8	0	0
17	78682983	.	G	T	3	4	7	0	0	8	1	0
17	87385885	.	T	G	12	4	16	0	1	17	0	0
17	88797008	.	G	T	7	3	10	0	0	10	0	0
17	88797009	.	C	T	7	2	9	0	1	10	0	0
17	95064364	.	T	C	2	4	6	0	0	6	0	0
17	95067396	.	T	C	16	9	25	0	0	25	0	0
17	95067479	.	T	C	20	15	35	0	2	37	0	0
17	95183909	.	T	A	1	0	1	0	0	1	0	0
18	5593495	.	A	C	2	2	4	0	0	4	0	0
18	6792757	.	A	G	30	10	40	0	0	40	0	0
18	6792802	.	A	G	29	11	40	0	1	41	0	0
18	6792857	.	A	G	18	9	27	0	2	29	0	0
18	6792866	.	A	G	23	12	35	0	0	35	0	0
18	6793746	.	A	G	14	7	21	0	1	22	0	0
18	6793749	.	A	G	16	6	22	0	0	22	0	0
18	6793792	.	A	G	25	5	30	0	1	31	0	0
18	7869231	.	A	G	18	6	24	0	1	25	0	0
18	12393386	.	A	G	3	2	5	0	0	5	0	0
18	21261539	.	C	T	4	6	10	0	2	12	0	0
18	24097662	.	A	C	5	2	7	0	0	7	0	0
18	24097663	.	A	C	4	1	5	0	2	7	0	0
18	25270986	.	C	A	5	7	12	0	3	15	0	0
18	31855447	.	A	G	1	2	3	0	1	4	0	0
18	32235595	.	A	G	2	8	10	0	0	10	0	0
18	32235643	.	A	G	7	4	11	0	1	12	0	0
18	32235652	.	A	G	3	5	8	0	3	11	0	0
18	32235915	.	A	G	3	2	5	0	0	5	0	0
18	32235930	.	A	G	0	1	1	0	0	1	0	0
18	32235964	.	A	G	0	1	1	0	0	1	0	0
18	32235981	.	A	G	3	1	4	0	0	4	0	0
18	32236019	.	A	G	5	4	9	0	1	10	0	0
18	35933343	.	A	G	6	2	8	0	0	8	0	0
18	37444052	.	A	G	1	1	2	0	0	2	0	0
18	38321747	.	A	C	0	2	2	0	0	2	0	0
18	43457365	.	C	T	13	0	13	0	2	15	0	0
18	43457368	.	C	T	11	1	12	0	3	15	0	0
18	43664579	.	G	T	10	3	13	0	1	14	0	0
18	43664583	.	G	T	12	2	14	0	1	15	0	0
18	46373038	.	T	C	8	2	10	0	0	10	0	0
18	47220402	.	C	T	15	0	15	0	4	19	0	0
18	61328635	.	T	C	4	2	6	0	0	6	0	0
18	62794853	.	A	G	4	2	6	0	0	6	0	0
18	65610148	.	A	G	4	3	7	0	0	7	0	0
18	65610199	.	A	G	5	2	7	0	0	7	0	0
18	69817384	.	T	C	17	5	22	0	1	25	2	0
18	77062550	.	A	G	10	11	21	0	0	21	0	0
18	77062557	.	A	G	17	5	22	0	0	22	0	0
19	3916385	.	A	G	10	2	12	0	0	12	0	0
19	3917362	.	A	G	3	2	5	0	0	5	0	0
19	4324082	.	T	C	1	2	3	0	0	3	0	0
19	4368397	.	A	G	8	4	12	0	8	20	0	0
19	4811045	.	T	C	8	2	10	0	0	10	0	0
19	4811061	.	T	C	7	4	11	0	0	11	0	0
19	4811133	.	T	C	8	2	10	0	0	10	0	0
19	4813117	.	T	C	5	4	9	0	0	9	0	0
19	6392304	.	A	T	1	1	2	0	1	3	0	0
19	6895771	.	T	C	6	2	8	0	0	8	0	0
19	6895783	.	T	C	5	3	8	0	0	8	0	0
19	7402857	.	A	C	12	4	16	0	8	24	0	0
19	7402866	.	A	C	12	3	15	0	8	23	0	0
19	7515480	.	A	G	30	8	38	0	0	38	0	0
19	8816891	.	A	C	11	4	15	0	7	22	0	0
19	8816897	.	A	C	17	3	20	0	6	26	0	0
19	8900145	.	A	G	2	4	6	0	0	6	0	0
19	10223060	.	T	C	33	78	111	0	1	112	0	0
19	10494226	.	T	C	2	2	4	0	0	4	0	0
19	10512634	.	A	C	15	6	21	0	2	23	0	0
19	10607183	.	G	A	6	2	8	0	0	8	0	0
19	10886122	.	A	G	4	2	6	0	0	6	0	0
19	10886159	.	A	G	4	3	7	0	0	7	0	0
19	12441626	.	A	G	39	7	46	0	1	47	0	0
19	16244498	.	G	A	0	1	1	0	0	1	0	0
19	16255683	.	T	C	1	0	1	0	0	1	0	0
19	23597387	.	T	C	3	2	5	3	0	8	0	0
19	34217616	.	C	T	3	2	5	0	2	7	0	0
19	38776795	.	T	C	5	2	7	0	0	7	0	0
19	42181806	.	A	C	9	4	13	0	5	18	0	0
19	43429365	.	A	G	13	3	16	0	1	17	0	0
19	43429601	.	A	G	14	20	34	0	1	35	0	0
19	43429686	.	A	G	27	6	33	0	1	34	0	0
19	43429753	.	A	G	34	7	41	0	2	43	0	0
19	44130353	.	T	C	11	2	13	0	0	13	0	0
19	44130371	.	T	C	7	4	11	0	0	11	0	0
19	44230124	.	T	C	3	0	3	0	0	3	0	0
19	44993669	.	T	C	52	10	62	0	1	63	0	0
19	46269419	.	A	G	2	2	4	0	0	4	0	0
2	3461293	.	A	G	1	2	3	0	0	3	0	0
2	5875569	.	A	G	4	2	6	0	0	6	0	0
2	14152798	.	A	G	15	5	20	0	2	22	0	0
2	14153492	.	A	G	2	8	10	0	1	11	0	0
2	14153493	.	A	G	2	9	11	0	0	11	0	0
2	14153560	.	A	G	3	10	13	0	0	13	0	0
2	14153568	.	A	G	5	8	13	0	0	13	0	0
2	16760131	.	C	T	9	3	12	0	0	12	0	0
2	18219466	.	T	C	5	7	12	0	0	12	0	0
2	18219472	.	T	C	3	10	13	0	1	14	0	0
2	18219544	.	T	C	7	3	10	0	0	10	0	0
2	22477366	.	T	C	0	3	3	0	0	3	0	0
2	22477570	.	T	C	0	1	1	0	1	2	0	0
2	22478451	.	A	G	0	2	2	0	0	2	0	0
2	22478588	.	G	A	0	2	2	0	0	2	0	0
2	26800818	.	C	T	5	2	7	0	0	7	0	0
2	26846568	.	T	C	2	2	4	0	0	4	0	0
2	27153718	.	T	C	7	3	10	0	0	10	0	0
2	28396998	.	A	G	6	3	9	0	0	9	0	0
2	29921460	.	T	A	8	2	10	0	1	11	0	0
2	29961694	.	C	T	7	16	23	5	8	36	0	0
2	30920944	.	T	C	23	8	31	0	0	31	0	0
2	30920955	.	T	C	22	10	32	0	0	32	0	0
2	32173436	.	T	C	1	2	3	0	0	3	0	0
2	32176109	.	T	C	2	2	4	0	0	4	0	0
2	32196762	.	A	G	59	11	70	0	1	71	0	0
2	35619401	.	T	C	11	5	16	0	16	32	0	0
2	37315924	.	T	C	16	3	19	0	0	19	0	0
2	37470941	.	G	A	5	2	7	0	1	8	0	0
2	38901971	.	A	G	6	2	8	0	0	8	0	0
2	38901977	.	A	G	8	2	10	0	0	10	0	0
2	40445910	.	G	T	0	4	4	3	1	8	0	0
2	40445978	.	T	C	0	5	5	3	0	8	0	0
2	50082797	.	G	A	15	8	23	0	2	25	0	0
2	55005781	.	C	T	16	4	20	0	1	21	0	0
2	55005783	.	G	T	15	4	19	0	2	21	0	0
2	60582281	.	A	G	7	2	9	0	0	9	0	0
2	76430897	.	T	C	4	2	6	0	0	6	0	0
2	77012350	.	A	C	7	3	10	0	7	17	0	0
2	77012356	.	A	C	7	7	14	0	2	16	0	0
2	91043632	.	A	G	41	15	56	0	1	57	0	0
2	91064732	.	T	C	11	4	15	0	0	15	0	0
2	91064743	.	T	C	10	3	13	0	1	14	0	0
2	104511117	.	T	C	26	14	40	0	0	40	0	0
2	104511123	.	T	C	29	8	37	0	0	37	0	0
2	112185846	.	A	G	4	2	6	0	0	6	0	0
2	112186208	.	A	G	7	3	10	0	0	10	0	0
2	112186230	.	A	G	10	2	12	0	0	12	0	0
2	118700340	.	A	G	8	5	13	0	1	14	0	0
2	118700801	.	A	G	11	10	21	0	0	21	0	0
2	119481395	.	T	C	7	2	9	0	0	9	0	0
2	121015462	.	A	G	8	2	10	0	0	10	0	0
2	126733408	.	T	C	3	8	11	0	0	11	0	0
2	126733437	.	T	C	8	2	10	0	0	10	0	0
2	126734836	.	T	C	17	7	24	0	1	25	0	0
2	127100503	.	A	G	11	9	20	0	24	46	2	0
2	130396840	.	A	G	2	9	11	0	0	11	0	0
2	130396876	.	A	G	7	13	20	0	1	21	0	0
2	130397775	.	A	G	6	3	9	0	0	9	0	0
2	130410056	.	A	G	6	5	11	0	0	11	0	0
2	130715901	.	T	C	4	2	6	0	0	6	0	0
2	132151800	.	A	G	65	364	429	0	4	433	0	0
2	132215681	.	A	G	4	2	6	0	0	6	0	0
2	140501239	.	C	T	12	5	17	0	5	22	0	0
2	149585919	.	C	T	0	1	1	0	1	2	0	0
2	152114942	.	A	G	2	9	11	0	1	12	0	0
2	153051040	.	C	A	6	4	10	0	10	28	8	0
2	153371617	.	C	T	4	1	5	0	0	5	0	0
2	153459226	.	T	C	1	2	3	0	0	3	0	0
2	153459246	.	T	C	2	2	4	0	0	4	0	0
2	153668153	.	T	C	0	4	4	1	0	5	0	0
2	154379850	.	A	G	32	11	43	0	1	44	0	0
2	157313041	.	A	C	8	5	13	0	10	23	0	0
2	157400030	.	T	C	84	23	107	0	2	110	1	0
2	157400060	.	T	C	78	29	107	0	3	110	0	0
2	157400069	.	T	C	59	41	100	0	1	101	0	0
2	158220838	.	A	G	10	12	22	0	1	23	0	0
2	158220905	.	A	G	15	5	20	0	0	20	0	0
2	158220906	.	A	G	14	6	20	0	0	20	0	0
2	158225545	.	A	G	309	64	373	0	2	376	1	0
2	158226873	.	A	G	66	391	457	0	15	472	0	0
2	158438117	.	T	C	8	2	10	0	0	10	0	0
2	158438124	.	T	C	7	2	9	0	0	9	0	0
2	163309459	.	T	C	12	10	22	0	0	22	0	0
2	163310335	.	T	C	18	4	22	0	0	22	0	0
2	164635687	.	T	C	1	5	6	0	0	6	0	0
2	164761458	.	A	G	6	2	8	0	0	8	0	0
2	164953773	.	T	C	38	11	49	0	1	50	0	0
2	166408278	.	A	G	12	4	16	0	0	16	0	0
2	168057882	.	T	C	3	2	5	0	0	5	0	0
2	169913325	.	A	G	5	2	7	0	0	7	0	0
2	174548497	.	C	T	4	1	5	0	2	7	0	0
2	181196317	.	G	A	10	2	12	0	0	12	0	0
3	20050356	.	C	T	6	2	8	0	0	8	0	0
3	26385911	.	T	C	11	3	14	0	2	16	0	0
3	32615620	.	A	G	21	5	26	0	0	26	0	0
3	32615624	.	C	T	14	16	30	0	0	30	0	0
3	32636549	.	T	C	10	3	13	0	0	13	0	0
3	36146643	.	A	G	2	2	4	0	0	4	0	0
3	37769174	.	G	T	1	0	1	3	0	4	0	0
3	40748697	.	A	G	36	15	51	0	0	51	0	0
3	51323503	.	T	G	2	1	3	0	4	7	0	0
3	53599973	.	A	T	2	0	2	1	0	3	0	0
3	57553351	.	T	C	1	6	7	0	0	7	0	0
3	57553356	.	T	C	6	2	8	0	0	8	0	0
3	65866372	.	A	G	3	3	6	0	0	6	0	0
3	68901456	.	T	C	1	3	4	0	1	5	0	0
3	80599593	.	T	C	10	54	64	0	1	65	0	0
3	80613850	.	T	C	23	5	28	0	0	28	0	0
3	80614159	.	T	C	13	17	30	0	0	30	0	0
3	80614215	.	T	C	135	50	185	0	2	187	0	0
3	85463819	.	T	C	2	4	6	0	0	6	0	0
3	88079367	.	G	A	5	3	8	0	2	10	0	0
3	88259488	.	A	G	1	4	5	0	0	5	0	0
3	88259498	.	A	G	0	7	7	0	0	7	0	0
3	88259542	.	A	G	11	3	14	0	0	14	0	0
3	88712709	.	T	C	12	4	16	0	0	16	0	0
3	88712739	.	T	C	19	8	27	0	0	27	0	0
3	89308434	.	T	C	3	4	7	0	0	7	0	0
3	89675221	.	T	C	11	3	14	0	0	14	0	0
3	89967705	.	A	G	0	2	2	0	0	2	0	0
3	89967924	.	A	G	1	6	7	0	0	7	0	0
3	89967938	.	A	G	3	3	6	0	0	6	0	0
3	90269081	.	T	C	5	0	5	0	10	15	0	0
3	90269085	.	T	C	1	4	5	0	7	12	0	0
3	90389599	.	A	G	1	2	3	0	0	3	0	0
3	92335373	.	G	T	2	1	3	0	1	4	0	0
3	95090872	.	T	C	5	2	7	0	0	7	0	0
3	95090893	.	T	C	6	2	8	0	0	8	0	0
3	95095436	.	T	C	14	3	17	0	0	17	0	0
3	96539776	.	A	G	7	29	36	0	2	38	0	0
3	96540029	.	A	G	35	9	44	0	3	47	0	0
3	101368173	.	G	A	3	3	6	0	0	6	0	0
3	102973406	.	A	G	32	16	48	0	0	48	0	0
3	103187243	.	A	G	23	4	27	0	0	27	0	0
3	104835351	.	A	G	4	4	8	0	1	9	0	0
3	116423212	.	A	G	4	3	7	0	0	7	0	0
3	116427215	.	T	C	3	2	5	0	0	5	0	0
3	116537795	.	T	C	11	3	14	0	0	14	0	0
3	116537812	.	T	C	17	6	23	0	0	23	0	0
3	116538330	.	T	C	6	12	18	0	1	19	0	0
3	116538353	.	T	C	13	6	19	0	1	20	0	0
3	121155810	.	G	A	13	3	16	0	0	16	0	0
3	133945718	.	A	G	3	2	5	0	0	5	0	0
3	135112631	.	T	C	56	14	70	0	0	70	0	0
3	138264847	.	A	G	21	4	25	0	0	25	0	0
4	4763464	.	C	T	50	20	70	0	5	75	0	0
4	9576791	.	G	A	14	9	23	0	1	24	0	0
4	17853635	.	C	T	13	3	16	0	0	16	0	0
4	21834548	.	A	G	20	11	31	0	1	32	0	0
4	21834574	.	A	G	22	8	30	0	0	30	0	0
4	21911313	.	A	G	18	5	23	0	0	23	0	0
4	21911667	.	A	G	10	7	17	0	0	17	0	0
4	21911675	.	A	G	14	7	21	0	1	22	0	0
4	32022582	.	A	G	49	8	57	0	2	59	0	0
4	33019420	.	A	G	82	39	121	0	5	126	0	0
4	33020417	.	A	G	67	77	144	0	1	145	0	0
4	42980014	.	C	T	30	3	33	0	10	43	0	0
4	43664077	.	G	C	2	0	2	3	0	5	0	0
4	43664414	.	A	C	3	3	6	0	0	6	0	0
4	43664415	.	A	T	3	3	6	0	0	6	0	0
4	45035088	.	A	G	16	2	18	0	7	25	0	0
4	45035092	.	T	G	13	4	17	0	6	23	0	0
4	46538360	.	A	G	17	10	27	0	10	37	0	0
4	56870144	.	T	C	15	3	18	0	0	18	0	0
4	56875812	.	T	C	5	6	11	0	0	11	0	0
4	59472245	.	C	T	6	4	10	0	4	14	0	0
4	59472251	.	G	T	5	3	8	0	2	10	0	0
4	62371004	.	T	C	3	2	5	0	0	5	0	0
4	86495344	.	G	T	68	17	85	0	1	87	1	0
4	87951385	.	G	C	1	1	2	0	2	4	0	0
4	94938161	.	A	C	5	3	8	0	4	12	0	0
4	103021909	.	A	G	15	8	23	0	3	26	0	0
4	103022599	.	A	G	32	7	39	0	0	39	0	0
4	108198313	.	A	G	9	12	21	0	0	21	0	0
4	115633195	.	G	T	5	1	6	0	4	10	0	0
4	115991567	.	T	C	15	4	19	0	0	19	0	0
4	116409479	.	T	C	9	2	11	0	0	11	0	0
4	116410052	.	T	C	12	3	15	0	1	16	0	0
4	116450680	.	C	T	11	5	16	0	3	19	0	0
4	118484005	.	A	G	13	29	42	0	0	42	0	0
4	118484072	.	A	G	11	5	16	0	1	17	0	0
4	119080724	.	T	C	18	4	22	0	1	23	0	0
4	119081410	.	T	C	6	6	12	0	2	14	0	0
4	124838094	.	A	G	11	13	24	0	0	24	0	0
4	124838169	.	A	G	15	6	21	1	0	22	0	0
4	125982944	.	A	G	7	13	20	0	0	20	0	0
4	125985078	.	A	G	7	6	13	0	0	13	0	0
4	125985458	.	A	G	16	3	19	0	0	19	0	0
4	126328822	.	C	T	3	2	5	0	0	6	1	0
4	129107038	.	A	G	5	3	8	0	0	8	0	0
4	137987341	.	A	G	92	19	111	0	2	113	0	0
4	137987354	.	A	G	75	22	97	0	4	101	0	0
4	139376720	.	A	C	9	2	11	0	9	20	0	0
4	139376726	.	A	C	11	5	16	0	3	19	0	0
4	140678893	.	A	G	8	6	14	0	0	14	0	0
4	149202586	.	A	G	26	9	35	0	0	35	0	0
4	149203211	.	A	G	12	9	21	0	0	21	0	0
4	149552635	.	T	C	2	6	8	0	1	9	0	0
4	150491027	.	G	A	20	0	20	0	8	28	0	0
4	155705891	.	A	G	1	3	4	0	1	5	0	0
4	155705982	.	A	G	11	2	13	0	1	14	0	0
4	155706828	.	A	G	10	5	15	0	3	18	0	0
4	155800341	.	A	G	11	4	15	0	0	15	0	0
4	155800935	.	A	G	4	7	11	0	1	12	0	0
4	155800938	.	A	G	7	3	10	0	2	12	0	0
4	155800978	.	A	G	9	4	13	0	0	13	0	0
4	156095123	.	A	G	77	66	143	0	3	146	0	0
4	156105007	.	T	C	1	2	3	0	0	3	0	0
4	156105008	.	T	C	1	2	3	0	0	3	0	0
4	156105693	.	T	C	3	4	7	0	0	7	0	0
4	156288985	.	A	T	2	0	2	0	2	4	0	0
4	156288986	.	T	G	2	0	2	0	2	4	0	0
4	156294088	.	A	G	1	3	4	0	1	5	0	0
5	5833142	.	A	G	0	5	5	2	0	7	0	0
5	5833426	.	A	G	3	1	4	0	0	4	0	0
5	5833442	.	T	C	0	4	4	0	1	5	0	0
5	20965859	.	T	C	8	3	11	0	0	11	0	0
5	22930927	.	A	G	0	2	2	17	0	19	0	0
5	24649804	.	T	C	8	20	28	2	0	30	0	0
5	24649822	.	T	C	19	9	28	2	3	33	0	0
5	26212431	.	A	G	2	4	6	0	0	6	0	0
5	26212434	.	G	C	2	3	5	0	1	6	0	0
5	29429060	.	G	T	3	1	4	0	0	4	0	0
5	29429063	.	T	C	3	1	4	0	0	4	0	0
5	30817017	.	G	A	2	2	4	0	0	4	0	0
5	31330824	.	T	C	1	0	1	0	0	1	0	0
5	33149571	.	A	G	10	4	14	0	0	14	0	0
5	33149755	.	A	G	17	4	21	0	1	22	0	0
5	33149943	.	A	G	8	6	14	0	0	14	0	0
5	33572684	.	A	G	8	2	10	0	1	11	0	0
5	33572691	.	A	G	11	3	14	0	0	14	0	0
5	33573262	.	A	G	6	4	10	0	0	10	0	0
5	33573281	.	A	G	2	10	12	0	0	12	0	0
5	33573900	.	A	G	3	3	6	0	0	6	0	0
5	33575654	.	A	G	5	3	8	0	0	8	0	0
5	33575740	.	A	G	5	3	8	0	0	8	0	0
5	63967611	.	G	A	6	6	12	0	4	16	0	0
5	65605388	.	T	C	63	18	81	0	2	83	0	0
5	65605389	.	T	C	41	39	80	0	3	83	0	0
5	65765485	.	A	G	5	2	7	0	1	8	0	0
5	69731172	.	A	G	9	2	11	0	0	11	0	0
5	73469787	.	A	G	58	12	70	0	0	70	0	0
5	77555578	.	T	C	2	24	26	0	0	26	0	0
5	81168532	.	G	A	5	2	7	0	1	8	0	0
5	110081429	.	C	T	3	3	6	0	0	6	0	0
5	110081431	.	C	T	3	3	6	0	0	6	0	0
5	110226907	.	G	A	0	2	2	0	0	2	0	0
5	110277544	.	A	G	11	2	13	0	0	13	0	0
5	111330935	.	T	C	3	1	4	0	0	4	0	0
5	114078736	.	T	C	15	3	18	0	0	18	0	0
5	115241332	.	T	C	0	3	3	6	0	9	0	0
5	115437319	.	T	C	9	4	13	0	0	13	0	0
5	115437904	.	T	C	3	2	5	0	0	5	0	0
5	117378654	.	A	C	1	3	4	0	0	4	0	0
5	117378659	.	A	C	1	3	4	0	0	4	0	0
5	121683511	.	T	C	20	3	23	0	0	23	0	0
5	121996809	.	A	G	9	1	10	0	2	12	0	0
5	121996812	.	T	G	8	2	10	0	3	13	0	0
5	121997078	.	C	T	11	3	14	0	4	18	0	0
5	121997079	.	C	T	14	3	17	0	1	18	0	0
5	122546590	.	A	G	16	4	20	0	2	22	0	0
5	122547221	.	A	G	12	2	14	0	0	14	0	0
5	122547656	.	A	G	3	3	6	0	0	6	0	0
5	122943915	.	C	T	2	2	4	0	0	4	0	0
5	123386729	.	A	G	19	9	28	0	0	28	0	0
5	123879315	.	T	C	7	8	15	0	0	15	0	0
5	123880012	.	G	T	2	1	3	0	2	5	0	0
5	123880013	.	G	T	1	2	3	0	2	5	0	0
5	123880070	.	T	C	8	2	10	0	0	10	0	0
5	125533669	.	A	G	40	55	95	0	1	96	0	0
5	125533830	.	A	G	14	3	17	0	0	17	0	0
5	125533970	.	A	G	37	9	46	0	1	47	0	0
5	125533971	.	A	G	38	8	46	0	1	47	0	0
5	125534541	.	A	G	63	41	104	0	2	107	1	0
5	129797823	.	A	G	9	17	26	0	1	27	0	0
5	129798517	.	A	G	16	5	21	0	1	22	0	0
5	130014307	.	A	G	67	11	78	0	2	80	0	0
5	130018011	.	A	G	6	2	8	0	2	10	0	0
5	131466449	.	C	T	6	3	9	0	5	14	0	0
5	132570854	.	T	A	3	3	6	0	2	8	0	0
5	135192126	.	A	G	9	2	11	0	0	11	0	0
5	135402657	.	A	G	1	2	3	0	0	3	0	0
5	135437709	.	T	C	12	5	17	0	0	17	0	0
5	135437715	.	T	C	13	4	17	0	0	17	0	0
5	136295593	.	C	A	5	2	7	0	0	7	0	0
5	136302928	.	C	T	3	0	3	0	2	5	0	0
5	136302936	.	G	T	4	0	4	0	1	5	0	0
5	136941953	.	A	G	111	31	142	0	2	144	0	0
5	137336165	.	T	C	2	4	6	0	0	6	0	0
5	139311355	.	C	T	2	1	3	0	1	4	0	0
5	140606797	.	C	G	16	8	24	0	10	36	2	0
5	140606802	.	T	G	18	12	30	0	14	44	0	0
5	142655047	.	A	G	88	35	123	0	0	123	0	0
5	142855980	.	T	C	1	4	5	0	0	5	0	0
5	144132139	.	C	T	2	2	4	0	0	4	0	0
6	29125157	.	A	T	7	1	8	0	4	12	0	0
6	29125158	.	C	T	4	0	4	0	9	13	0	0
6	29713997	.	A	G	2	1	3	0	1	4	0	0
6	31489106	.	A	G	4	3	7	0	1	8	0	0
6	31492600	.	A	G	11	3	14	0	0	14	0	0
6	31492602	.	A	G	9	5	14	0	0	14	0	0
6	34999041	.	A	G	7	2	9	0	0	9	0	0
6	37783098	.	C	T	5	0	5	1	2	8	0	0
6	37783131	.	C	T	0	2	2	2	0	4	0	0
6	37847782	.	A	G	12	4	16	0	0	16	0	0
6	38102459	.	G	A	4	6	10	1	1	12	0	0
6	38268267	.	T	C	7	2	9	0	0	9	0	0
6	38640156	.	C	T	2	1	3	0	2	5	0	0
6	47846393	.	A	G	9	3	12	0	0	12	0	0
6	47846415	.	A	G	14	3	17	0	0	17	0	0
6	47848349	.	A	G	8	6	14	0	1	15	0	0
6	47848373	.	A	G	9	4	13	0	0	13	0	0
6	47848652	.	A	G	3	1	4	0	1	5	0	0
6	47848659	.	A	G	1	3	4	0	0	4	0	0
6	47849226	.	A	G	5	2	7	0	0	7	0	0
6	49231812	.	T	C	4	2	6	0	2	8	0	0
6	49233394	.	T	C	11	3	14	0	0	14	0	0
6	65687581	.	G	A	4	2	6	0	0	6	0	0
6	65687646	.	A	G	6	2	8	0	0	8	0	0
6	66517065	.	A	G	1	2	3	0	0	3	0	0
6	66517625	.	A	G	9	7	16	0	0	16	0	0
6	66517737	.	A	G	8	2	10	0	1	11	0	0
6	67182761	.	T	C	0	2	2	0	0	2	0	0
6	86393034	.	A	G	1	3	4	0	1	5	0	0
6	87890574	.	G	A	4	2	6	0	0	6	0	0
6	96010042	.	T	C	0	4	4	2	0	6	0	0
6	96010183	.	T	C	5	2	7	1	0	8	0	0
6	113588107	.	A	G	3	2	5	0	0	5	0	0
6	113671744	.	G	T	2	0	2	0	2	4	0	0
6	113671755	.	G	T	3	1	4	0	1	5	0	0
6	115229054	.	G	A	1	1	2	0	2	4	0	0
6	115229055	.	C	A	2	0	2	0	2	4	0	0
6	115818036	.	T	C	9	3	12	0	0	12	0	0
6	117988411	.	G	A	5	2	7	0	0	7	0	0
6	122715481	.	T	C	1	2	3	0	0	3	0	0
6	124716624	.	T	C	5	3	8	0	0	8	0	0
6	124716628	.	T	C	4	5	9	0	0	9	0	0
6	124717238	.	T	C	7	5	12	0	0	12	0	0
6	124717252	.	T	C	0	7	7	0	1	8	0	0
6	124787015	.	A	G	4	8	12	0	0	12	0	0
6	124787022	.	T	G	5	8	13	0	0	13	0	0
6	125201005	.	A	G	2	2	4	0	0	4	0	0
6	126619121	.	T	C	65	28	93	0	3	96	0	0
6	128517235	.	C	T	3	1	4	0	1	5	0	0
6	128517243	.	C	T	5	0	5	0	1	6	0	0
6	133084860	.	A	G	7	2	9	0	0	9	0	0
6	134210508	.	C	G	1	0	1	0	0	1	0	0
6	134210513	.	C	G	1	0	1	0	0	1	0	0
6	134835326	.	C	T	11	4	15	0	0	15	0	0
6	135705675	.	A	G	34	9	43	0	17	60	0	0
6	142303840	.	G	A	1	2	3	0	0	3	0	0
6	148890858	.	G	A	1	3	4	0	5	9	0	0
6	148890859	.	C	A	1	1	2	0	7	9	0	0
7	4796292	.	A	C	8	6	14	0	7	21	0	0
7	6176879	.	A	G	2	2	4	0	0	4	0	0
7	6967909	.	A	G	9	8	17	0	0	17	0	0
7	6969443	.	A	G	26	5	31	0	1	32	0	0
7	6969451	.	A	G	10	14	24	0	0	24	0	0
7	6969513	.	A	G	11	25	36	0	0	36	0	0
7	12706119	.	A	G	6	3	9	0	1	10	0	0
7	12707543	.	A	G	4	3	7	0	1	8	0	0
7	12707548	.	A	G	5	3	8	0	0	8	0	0
7	15864164	.	G	C	4	8	12	0	8	20	0	0
7	15864170	.	T	C	6	9	15	0	5	20	0	0
7	16605458	.	T	C	9	4	13	0	0	13	0	0
7	16619272	.	A	G	7	82	89	0	0	89	0	0
7	16619450	.	A	G	14	5	19	0	0	19	0	0
7	16619714	.	A	G	75	19	94	0	0	94	0	0
7	18873686	.	T	C	15	7	22	0	0	22	0	0
7	18873733	.	T	C	8	6	14	0	0	14	0	0
7	18874314	.	T	C	22	7	29	0	0	29	0	0
7	18981774	.	C	G	0	8	8	0	0	8	0	0
7	19239403	.	T	C	2	2	4	0	0	4	0	0
7	19239404	.	T	C	1	2	3	0	1	4	0	0
7	23840812	.	T	C	0	1	1	0	0	1	0	0
7	23840839	.	A	G	7	1	8	0	0	8	0	0
7	23905313	.	G	A	1	3	4	0	0	4	0	0
7	23974184	.	G	A	0	6	6	0	1	7	0	0
7	23975294	.	A	G	0	4	4	3	0	7	0	0
7	24710068	.	T	C	44	15	59	0	1	60	0	0
7	24710075	.	T	C	42	16	58	0	1	59	0	0
7	25370976	.	A	G	1	2	3	0	0	3	0	0
7	25370997	.	A	G	1	2	3	0	0	3	0	0
7	26904341	.	A	G	3	2	5	0	1	6	0	0
7	26904993	.	A	G	1	8	9	0	0	9	0	0
7	26905060	.	A	G	4	4	8	0	0	8	0	0
7	27226586	.	T	C	77	16	93	0	2	95	0	0
7	27227593	.	T	C	85	22	107	0	3	110	0	0
7	27281313	.	A	G	34	7	41	0	0	41	0	0
7	27521368	.	A	G	9	6	15	0	1	16	0	0
7	41300739	.	G	T	3	4	7	0	5	12	0	0
7	42125604	.	A	G	9	3	12	0	0	12	0	0
7	43175439	.	T	C	7	2	9	0	0	9	0	0
7	44957315	.	T	C	0	2	2	0	0	2	0	0
7	45032973	.	T	C	5	7	12	0	0	12	0	0
7	45036567	.	A	G	4	1	5	0	0	5	0	0
7	45036981	.	A	C	1	3	4	0	0	4	0	0
7	45036987	.	A	C	2	2	4	0	1	5	0	0
7	49206073	.	A	G	1	2	3	0	0	3	0	0
7	55627368	.	T	C	57	34	91	0	1	92	0	0
7	58874873	.	T	C	6	2	8	0	0	8	0	0
7	58875215	.	T	C	1	6	7	0	0	7	0	0
7	58883467	.	T	C	2	3	5	0	0	5	0	0
7	61589804	.	T	C	1	2	3	0	1	4	0	0
7	65822438	.	G	T	9	2	11	0	1	12	0	0
7	65822439	.	G	T	9	2	11	0	1	12	0	0
7	79574216	.	T	C	2	3	5	0	0	5	0	0
7	79891696	.	A	G	4	7	11	0	0	11	0	0
7	81253540	.	T	C	22	6	28	0	0	28	0	0
7	81521958	.	A	G	9	3	12	0	0	12	0	0
7	83274886	.	T	C	7	3	10	0	1	11	0	0
7	83406162	.	T	C	0	4	4	9	0	13	0	0
7	89158473	.	A	G	5	2	7	0	1	8	0	0
7	103988513	.	T	C	0	2	2	0	0	2	0	0
7	110655309	.	T	C	22	21	43	0	3	46	0	0
7	121587468	.	T	C	2	4	6	0	0	6	0	0
7	122793209	.	G	A	1	5	6	0	1	7	0	0
7	123582103	.	A	G	32	5	37	0	0	37	0	0
7	123582585	.	A	G	16	5	21	0	0	21	0	0
7	126423019	.	G	C	10	8	18	0	2	20	0	0
7	126423022	.	A	C	11	5	16	0	1	17	0	0
7	126465028	.	G	A	2	3	5	0	4	9	0	0
7	126465030	.	C	A	2	4	6	0	4	10	0	0
7	126468724	.	C	T	0	3	3	0	1	4	0	0
7	126853494	.	A	G	34	12	46	0	0	46	0	0
7	127043915	.	A	G	4	2	6	0	1	7	0	0
7	127178167	.	A	G	4	3	7	0	0	7	0	0
7	127178178	.	A	G	2	5	7	0	0	7	0	0
7	127178234	.	A	G	1	2	3	0	0	3	0	0
7	127519013	.	A	G	1	2	3	0	0	3	0	0
7	130360893	.	A	T	2	3	5	0	0	5	0	0
7	132585914	.	G	A	1	1	2	0	2	4	0	0
7	132585919	.	G	A	1	2	3	0	0	3	0	0
7	139715640	.	A	G	1	8	9	0	0	9	0	0
7	139715696	.	A	G	2	4	6	0	0	6	0	0
7	139716717	.	A	G	5	2	7	0	0	7	0	0
7	140391011	.	T	C	22	4	26	0	0	26	0	0
7	140391023	.	T	C	16	8	24	0	1	25	0	0
7	140471558	.	G	A	3	0	3	0	0	3	0	0
7	140916604	.	A	G	30	7	37	0	5	42	0	0
7	141503659	.	T	C	12	5	17	0	0	18	1	0
7	141503671	.	G	C	13	0	13	0	0	13	0	0
7	142207010	.	T	C	46	14	60	0	1	61	0	0
7	142207465	.	T	C	40	10	50	0	3	53	0	0
8	5689763	.	A	G	0	2	2	4	1	7	0	0
8	10020882	.	A	G	1	1	2	0	3	5	0	0
8	12688987	.	C	T	2	3	5	0	0	5	0	0
8	14078025	.	T	C	8	2	10	0	0	10	0	0
8	19741629	.	C	T	0	1	1	0	0	1	0	0
8	19747709	.	C	T	2	8	10	4	0	14	0	0
8	20030704	.	C	T	25	5	30	2	0	32	0	0
8	20030843	.	C	T	13	3	16	0	0	16	0	0
8	20030855	.	G	A	10	3	13	0	0	13	0	0
8	20030895	.	C	A	5	2	7	0	0	7	0	0
8	20030901	.	C	A	5	1	6	0	0	6	0	0
8	20157920	.	G	T	5	5	10	0	0	10	0	0
8	20698008	.	A	T	12	5	17	4	0	21	0	0
8	20727130	.	G	A	21	14	35	0	0	35	0	0
8	26303402	.	C	T	3	1	4	0	1	5	0	0
8	27537841	.	A	G	2	2	4	0	0	4	0	0
8	34603275	.	G	T	20	3	23	0	9	32	0	0
8	39618334	.	C	A	17	6	23	0	1	24	0	0
8	42061914	.	T	C	0	2	2	0	0	2	0	0
8	42700052	.	A	G	0	1	1	0	0	1	0	0
8	42700280	.	T	C	0	1	1	2	0	3	0	0
8	42700336	.	G	A	7	0	7	0	1	8	0	0
8	48005015	.	G	T	16	4	20	0	2	22	0	0
8	61848427	.	G	T	4	2	6	0	4	10	0	0
8	69766592	.	A	G	8	3	11	0	1	12	0	0
8	69927015	.	A	T	0	1	1	0	0	1	0	0
8	70028598	.	G	A	3	0	3	0	0	3	0	0
8	70028756	.	G	A	1	0	1	0	1	2	0	0
8	70037749	.	C	T	0	2	2	4	0	6	0	0
8	71131397	.	G	A	2	1	3	0	1	4	0	0
8	71826392	.	A	G	13	5	18	0	0	18	0	0
8	72977426	.	A	G	22	45	67	0	1	69	1	0
8	73236514	.	T	C	74	13	87	0	1	88	0	0
8	84723069	.	T	A	4	2	6	0	1	7	0	0
8	84977744	.	T	C	2	1	3	0	0	3	0	0
8	88898496	.	A	G	14	5	19	0	0	19	0	0
8	91842902	.	T	C	3	2	5	0	0	5	0	0
8	92394226	.	T	C	26	10	36	0	20	56	0	0
8	94743910	.	T	C	12	4	16	0	0	16	0	0
8	94744391	.	G	T	11	5	16	0	0	16	0	0
8	94744392	.	G	T	11	5	16	0	0	16	0	0
8	94744437	.	A	T	11	2	13	0	18	31	0	0
8	94806362	.	T	C	5	2	7	0	0	7	0	0
8	94879775	.	A	C	2	1	3	0	3	6	0	0
8	94879781	.	A	C	4	1	5	0	3	8	0	0
8	96099873	.	G	C	7	3	10	0	3	13	0	0
8	104984451	.	A	G	1	2	3	0	0	3	0	0
8	104985791	.	A	G	1	2	3	0	0	3	0	0
8	104986580	.	A	G	2	3	5	0	0	5	0	0
8	104987504	.	A	G	0	3	3	0	0	3	0	0
8	107744848	.	A	G	6	5	11	0	0	11	0	0
8	108165816	.	G	A	1	3	4	1	1	6	0	0
8	110817217	.	A	G	29	11	40	0	3	43	0	0
8	111731758	.	T	C	25	9	34	0	1	35	0	0
8	121821599	.	T	C	4	2	6	0	0	6	0	0
8	121823764	.	T	C	1	3	4	0	0	4	0	0
8	123355941	.	C	T	2	2	4	0	1	5	0	0
8	125620613	.	T	C	13	4	17	0	4	21	0	0
8	125620618	.	T	C	9	10	19	0	0	19	0	0
8	125620861	.	T	C	24	10	34	0	0	34	0	0
8	125620923	.	T	C	5	32	37	0	0	37	0	0
8	125620929	.	T	C	11	20	31	0	0	31	0	0
8	130007592	.	T	A	1	0	1	0	0	1	0	0
9	3386017	.	A	G	13	3	16	0	0	16	0	0
9	3387701	.	A	G	11	4	15	0	0	15	0	0
9	3387771	.	A	G	20	7	27	0	2	29	0	0
9	3387790	.	A	G	15	2	17	0	0	17	0	0
9	4456006	.	T	C	0	2	2	0	1	3	0	0
9	7836215	.	A	G	5	2	7	0	0	8	1	0
9	8022080	.	T	C	16	3	19	0	0	19	0	0
9	14691487	.	G	T	5	4	9	0	3	12	0	0
9	14691492	.	G	T	4	1	5	0	7	12	0	0
9	20508055	.	A	G	9	2	11	0	1	12	0	0
9	20512895	.	A	G	3	2	5	0	0	5	0	0
9	20515757	.	A	G	4	4	8	0	0	8	0	0
9	20781697	.	A	G	27	6	33	0	0	33	0	0
9	21044730	.	T	C	1	3	4	0	0	4	0	0
9	22189251	.	G	A	6	3	9	0	1	10	0	0
9	28832950	.	A	C	9	7	16	0	25	41	0	0
9	42163217	.	T	G	18	4	22	0	3	25	0	0
9	43715978	.	C	T	21	7	28	0	4	32	0	0
9	44035400	.	T	C	2	1	3	0	0	3	0	0
9	44035408	.	T	C	2	1	3	0	0	3	0	0
9	44206135	.	T	C	8	2	10	0	0	10	0	0
9	44221129	.	T	C	2	5	7	0	0	7	0	0
9	44221511	.	A	T	4	3	7	0	0	7	0	0
9	44303470	.	G	C	4	2	6	0	4	10	0	0
9	44419703	.	A	C	10	2	12	0	6	18	0	0
9	44419709	.	A	C	9	4	13	0	2	15	0	0
9	45747294	.	C	T	0	2	2	1	0	3	0	0
9	45747425	.	T	C	0	2	2	1	0	3	0	0
9	45747428	.	A	T	0	2	2	1	0	3	0	0
9	50436200	.	T	G	6	1	7	0	0	7	0	0
9	50436201	.	G	T	6	1	7	0	0	7	0	0
9	52588130	.	T	A	4	1	5	0	19	24	0	0
9	52588131	.	T	A	3	0	3	0	19	25	3	0
9	54623600	.	C	A	0	2	2	0	0	2	0	0
9	57041680	.	A	G	9	2	11	0	0	11	0	0
9	57051592	.	T	C	2	2	4	0	0	4	0	0
9	57321026	.	A	T	6	2	8	0	0	8	0	0
9	57658827	.	C	T	6	2	8	0	0	8	0	0
9	59878603	.	A	G	7	3	10	0	1	11	0	0
9	61324884	.	A	C	6	2	8	0	2	10	0	0
9	61324889	.	A	C	8	3	11	0	1	12	0	0
9	62758716	.	G	C	6	2	8	0	8	16	0	0
9	65253476	.	A	G	5	2	7	0	0	7	0	0
9	70511854	.	A	T	16	5	21	0	2	23	0	0
9	70511858	.	G	T	17	2	19	0	1	20	0	0
9	72270786	.	C	A	15	7	22	0	4	26	0	0
9	72366863	.	T	C	4	3	7	0	0	7	0	0
9	75601320	.	A	G	0	2	2	2	0	4	0	0
9	85727653	.	G	T	11	3	14	0	3	17	0	0
9	95939293	.	A	G	25	6	31	0	0	31	0	0
9	103062470	.	C	A	3	3	6	0	0	6	0	0
9	103062472	.	C	A	2	3	5	0	1	6	0	0
9	107640487	.	T	C	4	3	7	0	0	7	0	0
9	110255487	.	T	G	0	1	1	0	4	5	0	0
9	118872057	.	G	T	9	2	11	0	0	11	0	0
9	118872058	.	A	T	8	1	9	0	2	11	0	0
9	122899539	.	T	C	6	1	7	0	0	7	0	0
9	123349983	.	A	G	13	2	15	0	0	15	0	0
9	123525510	.	G	A	8	2	10	0	1	11	0	0
9	124034058	.	T	G	11	3	14	2	0	16	0	0
9	124034094	.	A	G	3	4	7	0	0	7	0	0
X	7773342	.	A	G	7	2	9	0	0	9	0	0
X	7773818	.	A	G	4	2	6	0	0	6	0	0
X	40743129	.	A	G	2	11	13	0	0	13	0	0
X	40743165	.	A	G	4	2	6	0	0	6	0	0
X	55633003	.	T	C	33	10	43	0	0	43	0	0
X	55695874	.	A	G	1	3	4	0	0	4	0	0
X	60231705	.	A	G	7	6	13	0	0	13	0	0
X	69388256	.	T	C	35	11	46	0	1	47	0	0
X	70866409	.	C	T	8	2	10	0	0	10	0	0
X	73270255	.	T	C	6	7	13	0	0	13	0	0
X	73270256	.	T	C	2	11	13	0	0	13	0	0
X	73270468	.	T	C	1	15	16	0	0	16	0	0
X	82861767	.	A	G	5	2	7	0	0	7	0	0
X	87616192	.	T	G	0	1	1	0	0	1	0	0
X	97364566	.	G	C	17	2	19	0	0	19	0	0
X	97756635	.	G	A	6	1	7	0	1	8	0	0
X	100868318	.	T	C	0	2	2	1	0	3	0	0
X	102620090	.	T	C	2	10	12	0	0	12	0	0
X	102620158	.	T	C	2	6	8	0	0	8	0	0
X	102620159	.	T	C	2	6	8	0	0	8	0	0
X	102631489	.	T	C	5	2	7	0	0	7	0	0
X	105063008	.	A	G	12	2	14	0	0	14	0	0
X	133490101	.	T	C	6	3	9	0	0	9	0	0
X	133490145	.	T	C	6	2	8	0	0	8	0	0
X	145978689	.	A	G	44	13	57	0	0	57	0	0
X	149766871	.	T	C	17	19	36	0	7	43	0	0
X	149767614	.	T	C	90	71	161	0	4	165	0	0
X	149768450	.	T	C	148	49	197	0	2	199	0	0
X	149768451	.	T	C	158	38	196	0	3	199	0	0
X	149768519	.	T	C	253	41	294	0	3	297	0	0
X	149768525	.	T	C	168	87	255	0	4	259	0	0
X	164972992	.	A	G	9	5	14	0	0	14	0	0
Y	1016394	.	A	G	16	15	31	0	0	31	0	0
Y	1048726	.	A	G	4	3	7	0	0	7	0	0
Y	1049036	.	A	G	3	2	5	0	0	5	0	0
