contig	position	variantID	refAllele	altAllele	refCount	altCount	totalCount	lowMAPQDepth	lowBaseQDepth	rawDepth	otherBases	improperPairs
1	9790061	.	T	C	8	4	12	0	0	12	0	0
1	9790109	.	T	C	5	2	7	0	0	7	0	0
1	13695965	.	T	C	7	6	13	0	0	13	0	0
1	22031785	.	T	C	3	10	13	0	0	13	0	0
1	37448671	.	G	T	1	3	4	0	1	5	0	0
1	39590794	.	A	T	7	4	11	0	2	13	0	0
1	39590795	.	G	T	7	4	11	0	2	13	0	0
1	51506146	.	T	C	1	2	3	0	0	3	0	0
1	51507738	.	T	C	1	1	2	0	1	3	0	0
1	51507771	.	T	C	0	2	2	0	0	2	0	0
1	58566410	.	C	T	15	5	20	0	1	21	0	0
1	58635113	.	G	A	1	2	3	0	0	3	0	0
1	59756998	.	A	G	4	2	6	0	0	6	0	0
1	59913367	.	A	G	38	19	57	0	1	58	0	0
1	60191150	.	A	G	2	2	4	0	3	7	0	0
1	60517747	.	A	G	27	21	48	1	8	57	0	0
1	63156443	.	A	G	1	6	7	0	0	7	0	0
1	66711873	.	A	G	47	31	78	0	2	80	0	0
1	74534986	.	C	A	0	0	0	0	1	1	0	0
1	74631584	.	A	G	4	2	6	0	0	6	0	0
1	75398649	.	A	G	21	5	26	0	1	27	0	0
1	75398702	.	A	G	17	3	20	0	0	20	0	0
1	75398708	.	A	G	3	16	19	0	2	21	0	0
1	86276528	.	T	C	10	5	15	0	0	15	0	0
1	88187311	.	C	T	0	2	2	0	0	2	0	0
1	88187834	.	G	A	1	2	3	0	1	4	0	0
1	88188121	.	A	C	2	4	6	0	1	7	0	0
1	88188150	.	C	A	1	5	6	0	0	6	0	0
1	88188255	.	C	T	3	2	5	0	0	5	0	0
1	88188277	.	C	G	2	2	4	0	0	4	0	0
1	88188444	.	G	C	1	2	3	0	0	3	0	0
1	88188461	.	C	G	1	2	3	0	0	3	0	0
1	88189404	.	C	T	2	3	5	0	0	5	0	0
1	88189563	.	C	T	3	4	7	0	0	7	0	0
1	88189611	.	A	G	2	3	5	0	0	5	0	0
1	88189641	.	G	C	1	3	4	0	0	4	0	0
1	88189668	.	A	G	0	4	4	0	0	4	0	0
1	88189685	.	C	A	2	2	4	0	0	4	0	0
1	88189707	.	C	T	4	2	6	0	1	7	0	0
1	88189784	.	A	G	2	2	4	0	0	4	0	0
1	88189938	.	C	A	1	2	3	0	0	3	0	0
1	88190661	.	G	C	4	2	6	0	0	6	0	0
1	88190717	.	G	C	5	5	10	0	0	10	0	0
1	88190781	.	C	T	2	2	4	0	1	5	0	0
1	88190921	.	C	T	1	8	9	0	1	10	0	0
1	88191018	.	A	T	2	9	11	0	0	11	0	0
1	88191035	.	T	A	3	7	10	0	0	10	0	0
1	88191237	.	A	C	9	34	43	0	2	45	0	0
1	88191320	.	C	T	9	23	32	0	0	32	0	0
1	88191468	.	C	G	5	58	63	0	2	65	0	0
1	88191706	.	G	A	24	7	31	0	0	31	0	0
1	88191710	.	T	C	10	20	30	0	0	30	0	0
1	88191864	.	G	T	53	8	61	0	1	62	0	0
1	88192008	.	C	T	44	10	54	0	6	60	0	0
1	88192048	.	G	C	10	35	45	0	0	45	0	0
1	88192098	.	G	A	40	14	54	0	0	54	0	0
1	88192243	.	A	G	8	44	52	0	1	53	0	0
1	88192700	.	G	A	12	35	47	0	0	47	0	0
1	88192756	.	G	A	12	44	56	0	1	57	0	0
1	88192980	.	A	G	1	42	43	1	3	47	0	0
1	88193031	.	C	G	10	18	28	0	1	29	0	0
1	88193194	.	C	T	1	7	8	0	1	9	0	0
1	88193292	.	T	A	0	3	3	7	0	10	0	0
1	88193568	.	A	C	1	4	5	0	0	5	0	0
1	88193917	.	G	A	9	20	29	0	2	31	0	0
1	88197053	.	T	C	1	6	7	0	0	7	0	0
1	88197991	.	A	G	6	18	24	0	0	24	0	0
1	88200605	.	C	A	0	8	8	0	0	8	0	0
1	88200653	.	A	C	0	11	11	0	0	11	0	0
1	88200771	.	G	A	9	2	11	0	0	11	0	0
1	88200832	.	C	T	6	10	16	0	1	17	0	0
1	88202664	.	A	G	0	2	2	0	0	2	0	0
1	88202772	.	A	T	2	0	2	0	0	2	0	0
1	88203670	.	C	T	1	2	3	0	0	3	0	0
1	88203782	.	G	A	0	4	4	0	0	4	0	0
1	88204960	.	T	C	1	5	6	1	0	7	0	0
1	89879528	.	A	C	3	1	4	0	0	4	0	0
1	93299307	.	A	G	12	3	15	0	0	15	0	0
1	118225383	.	C	T	6	2	8	0	0	8	0	0
1	118225697	.	T	C	6	2	8	0	0	8	0	0
1	131953439	.	T	C	11	13	24	0	0	24	0	0
1	143631121	.	T	C	21	8	29	0	0	29	0	0
1	155881055	.	A	G	0	2	2	0	2	4	0	0
1	156255182	.	T	C	3	11	14	0	0	14	0	0
1	156255601	.	T	C	6	4	10	0	0	10	0	0
1	160831257	.	G	A	8	2	10	0	1	11	0	0
1	160835342	.	T	C	5	2	7	0	0	7	0	0
1	160835343	.	T	C	4	3	7	0	0	7	0	0
1	160839934	.	T	C	3	2	5	0	0	5	0	0
1	162425767	.	A	G	44	10	54	0	5	59	0	0
1	171109565	.	A	G	8	2	10	0	1	11	0	0
1	178779812	.	T	C	8	3	11	0	1	12	0	0
1	180155087	.	T	C	2	2	4	0	1	5	0	0
1	180924020	.	T	C	18	6	24	0	1	25	0	0
1	181731983	.	A	G	21	12	33	1	1	35	0	0
1	183190594	.	A	G	9	7	16	0	0	16	0	0
1	183190682	.	A	G	12	4	16	0	0	16	0	0
10	5752116	.	A	G	4	24	28	2	0	30	0	0
10	5752204	.	A	G	3	4	7	2	0	9	0	0
10	5752387	.	A	C	1	6	7	5	0	12	0	0
10	5775697	.	A	G	1	3	4	0	0	4	0	0
10	11333810	.	C	T	17	8	25	0	5	30	0	0
10	11333814	.	C	T	20	6	26	0	4	30	0	0
10	14621525	.	C	T	1	0	1	0	0	1	0	0
10	14621526	.	C	T	1	0	1	0	0	1	0	0
10	18877832	.	A	G	5	2	7	0	0	7	0	0
10	33868452	.	T	C	5	4	9	0	0	9	0	0
10	38998051	.	A	C	5	2	7	0	0	7	0	0
10	49118584	.	T	C	4	4	8	0	0	8	0	0
10	49118640	.	T	C	12	5	17	0	0	17	0	0
10	49120426	.	T	C	0	8	8	0	0	8	0	0
10	49148872	.	T	C	2	23	25	0	0	25	0	0
10	49148885	.	T	C	3	24	27	0	0	27	0	0
10	57383221	.	A	G	2	3	5	0	0	5	0	0
10	57391874	.	C	T	6	4	10	0	0	10	0	0
10	62645542	.	T	C	2	2	4	0	0	4	0	0
10	62645914	.	T	C	3	2	5	0	1	6	0	0
10	69860458	.	G	A	5	21	26	0	5	31	0	0
10	73038538	.	A	G	0	5	5	0	0	5	0	0
10	76391416	.	A	G	9	4	13	0	1	14	0	0
10	76391424	.	A	G	9	5	14	0	0	14	0	0
10	80784471	.	A	G	6	2	8	0	1	9	0	0
10	81182083	.	T	C	25	4	29	0	0	29	0	0
10	81445420	.	G	A	1	2	3	0	0	3	0	0
10	82486613	.	T	C	17	8	25	0	0	25	0	0
10	93582974	.	C	A	1	2	3	0	0	3	0	0
10	93800484	.	T	C	12	3	15	0	0	15	0	0
10	93801937	.	T	C	6	3	9	0	0	9	0	0
10	94057224	.	A	G	8	7	15	0	0	15	0	0
10	94057234	.	A	G	10	5	15	0	0	15	0	0
10	119035181	.	A	G	8	2	10	0	0	10	0	0
11	3407590	.	A	G	7	2	9	0	0	9	0	0
11	4091399	.	T	C	13	3	16	0	0	16	0	0
11	4092085	.	T	C	14	12	26	0	0	26	0	0
11	4092790	.	T	C	14	13	27	0	0	27	0	0
11	24117920	.	G	A	5	3	8	0	0	8	0	0
11	35678738	.	A	G	42	7	49	0	2	51	0	0
11	43572939	.	A	G	3	4	7	0	0	7	0	0
11	43572970	.	A	G	5	2	7	0	0	7	0	0
11	43573028	.	A	G	4	3	7	0	0	7	0	0
11	45821425	.	T	C	10	4	14	0	0	14	0	0
11	46163470	.	T	C	38	184	222	0	1	223	0	0
11	48644072	.	A	T	0	2	2	21	0	23	0	0
11	48691187	.	C	T	24	14	38	0	0	38	0	0
11	52124644	.	A	G	3	3	6	0	0	6	0	0
11	53440228	.	A	G	120	120	240	0	12	252	0	0
11	54730814	.	T	C	13	4	17	0	0	17	0	0
11	59223663	.	T	G	2	1	3	0	4	7	0	0
11	59347027	.	A	G	13	10	23	0	0	23	0	0
11	59347029	.	A	G	12	11	23	0	0	23	0	0
11	59347072	.	A	G	16	4	20	0	0	20	0	0
11	59401881	.	A	G	5	4	9	0	0	9	0	0
11	67579383	.	C	G	9	4	13	0	19	32	0	0
11	69514179	.	A	G	7	2	9	0	0	9	0	0
11	69807381	.	G	A	8	2	10	0	0	10	0	0
11	69922950	.	A	G	5	3	8	0	0	8	0	0
11	69923921	.	A	G	4	2	6	0	1	7	0	0
11	69926813	.	A	G	2	4	6	0	0	6	0	0
11	69927946	.	A	G	6	6	12	0	0	12	0	0
11	74747553	.	T	C	1	2	3	0	0	3	0	0
11	75067170	.	T	C	25	18	43	0	1	44	0	0
11	75067258	.	T	C	19	12	31	0	0	31	0	0
11	75068285	.	T	C	21	7	28	0	0	28	0	0
11	77426880	.	T	C	34	13	47	0	0	47	0	0
11	78187480	.	A	G	1	2	3	0	0	3	0	0
11	78736472	.	A	G	0	7	7	0	0	7	0	0
11	82791835	.	C	G	2	0	2	0	6	8	0	0
11	86521333	.	T	C	1	3	4	3	0	7	0	0
11	86521517	.	A	G	0	1	1	2	2	5	0	0
11	87014114	.	A	G	11	2	13	0	0	13	0	0
11	88083921	.	T	C	7	2	9	0	0	9	0	0
11	88927134	.	T	C	6	2	8	0	1	9	0	0
11	88927208	.	T	C	4	11	15	0	0	15	0	0
11	95401202	.	A	G	10	6	16	0	3	19	0	0
11	97285031	.	A	C	5	4	9	0	1	10	0	0
11	97535690	.	T	C	15	5	20	0	0	20	0	0
11	97536428	.	T	C	17	4	21	0	0	21	0	0
11	97598552	.	A	G	3	2	5	0	0	5	0	0
11	97734000	.	A	G	46	10	56	0	3	59	0	0
11	98787088	.	T	C	4	0	4	0	1	5	0	0
11	99277008	.	A	G	5	2	7	0	0	7	0	0
11	100488792	.	T	C	7	5	12	0	0	12	0	0
11	101080710	.	A	C	13	5	18	0	3	21	0	0
11	101080714	.	G	C	14	5	19	0	8	27	0	0
11	101089557	.	T	C	11	4	15	0	0	15	0	0
11	101089729	.	T	C	8	2	10	0	2	12	0	0
11	101089802	.	T	C	5	5	10	0	1	11	0	0
11	102366881	.	A	T	5	1	6	0	3	9	0	0
11	102366884	.	G	T	3	0	3	0	6	9	0	0
11	102837091	.	T	C	7	4	11	0	0	11	0	0
11	105068803	.	T	C	2	2	4	0	0	4	0	0
11	105068804	.	T	C	2	2	4	0	0	4	0	0
11	109148234	.	T	C	2	2	4	0	0	4	0	0
11	109612977	.	G	A	3	1	4	0	0	4	0	0
11	116303813	.	T	C	4	3	7	0	0	7	0	0
11	116471963	.	T	C	7	34	41	0	0	41	0	0
11	120519173	.	C	T	11	7	18	0	0	18	0	0
11	120519181	.	A	T	11	1	12	0	6	18	0	0
12	3454168	.	A	G	42	9	51	0	1	52	0	0
12	3454248	.	A	G	16	22	38	0	6	44	0	0
12	3454647	.	A	G	37	45	82	0	5	87	0	0
12	3454648	.	A	G	66	19	85	0	2	87	0	0
12	3958221	.	C	T	7	4	11	0	4	15	0	0
12	3958222	.	C	T	6	1	7	0	8	15	0	0
12	8547666	.	A	T	1	2	3	0	0	3	0	0
12	15778865	.	A	T	2	2	4	0	0	4	0	0
12	17479602	.	A	G	8	3	11	0	1	12	0	0
12	17479613	.	A	G	4	4	8	0	0	8	0	0
12	17479809	.	A	G	13	12	25	0	1	26	0	0
12	17479860	.	A	G	19	5	24	0	0	24	0	0
12	27388168	.	G	T	6	1	7	0	1	8	0	0
12	46747117	.	T	C	44	12	56	0	1	57	0	0
12	51418190	.	A	G	1	2	3	0	0	3	0	0
12	54718540	.	T	C	30	15	45	0	0	45	0	0
12	54719142	.	T	C	21	6	27	0	0	27	0	0
12	69244102	.	A	G	16	6	22	0	0	22	0	0
12	69355129	.	C	T	1	1	2	0	1	3	0	0
12	71041403	.	A	G	6	32	38	0	0	38	0	0
12	71041903	.	A	G	4	13	17	0	1	18	0	0
12	71041909	.	A	G	12	4	16	0	0	16	0	0
12	71041945	.	A	G	19	7	26	0	2	28	0	0
12	71041954	.	A	G	16	12	28	0	2	30	0	0
12	71041984	.	A	G	21	10	31	0	1	32	0	0
12	72955836	.	T	C	5	2	7	0	0	7	0	0
12	72955837	.	T	C	3	4	7	0	0	7	0	0
12	72956113	.	T	C	12	5	17	0	0	17	0	0
12	72956114	.	T	C	15	2	17	0	0	17	0	0
12	72956148	.	T	C	0	11	11	0	0	11	0	0
12	72956155	.	T	C	6	4	10	0	0	10	0	0
12	73975614	.	A	G	4	4	8	0	0	8	0	0
12	75678010	.	C	T	3	3	6	3	0	9	0	0
12	78887986	.	T	C	5	3	8	0	1	9	0	0
12	80770510	.	A	G	4	2	6	0	0	6	0	0
12	80770523	.	A	G	0	6	6	0	0	6	0	0
12	81245339	.	G	A	12	16	28	0	1	29	0	0
12	81419057	.	T	C	0	2	2	0	0	2	0	0
12	81419225	.	C	T	2	0	2	0	1	3	0	0
12	81419593	.	T	C	0	1	1	0	0	1	0	0
12	83582758	.	G	A	0	1	1	0	0	1	0	0
12	100837974	.	A	G	5	4	9	0	0	9	0	0
12	101886131	.	T	C	16	7	23	0	1	24	0	0
12	101887890	.	T	C	14	6	20	0	0	20	0	0
12	104831249	.	G	A	1	1	2	0	0	2	0	0
12	109511197	.	C	A	5	4	9	0	11	20	0	0
12	109511202	.	C	A	5	18	23	0	2	25	0	0
12	109525448	.	A	G	581	96	677	0	11	689	1	0
12	116018543	.	A	G	0	4	4	0	1	5	0	0
12	116369364	.	G	C	0	4	4	0	0	4	0	0
13	3702324	.	A	G	5	2	7	0	2	9	0	0
13	3702325	.	A	G	6	2	8	0	1	9	0	0
13	3703271	.	T	A	3	6	9	0	0	10	1	0
13	5918220	.	T	C	15	4	19	0	14	33	0	0
13	8901801	.	T	C	10	3	13	0	0	13	0	0
13	14228102	.	T	C	24	6	30	0	2	32	0	0
13	17978887	.	T	C	7	3	10	0	0	10	0	0
13	17978950	.	T	C	1	4	5	0	0	5	0	0
13	17979133	.	T	C	5	3	8	0	0	8	0	0
13	21571267	.	G	T	1	2	3	0	0	3	0	0
13	21571270	.	C	T	1	1	2	0	1	3	0	0
13	21574169	.	T	C	5	5	10	0	0	10	0	0
13	21574225	.	T	C	12	5	17	0	0	17	0	0
13	21576493	.	T	C	2	2	4	0	0	4	0	0
13	24999535	.	A	G	0	4	4	0	0	4	0	0
13	29133075	.	G	T	1	3	4	0	0	5	1	0
13	29133076	.	C	T	1	4	5	0	0	5	0	0
13	38401726	.	T	C	3	2	5	0	0	5	0	0
13	47163686	.	T	C	2	2	4	1	0	5	0	0
13	51305477	.	A	T	5	1	6	1	29	36	0	0
13	59757017	.	A	G	2	2	4	0	0	4	0	0
13	64438124	.	T	C	12	3	15	0	0	15	0	0
13	67621265	.	T	C	4	5	9	0	0	9	0	0
13	67806944	.	T	C	2	3	5	0	1	6	0	0
13	67807003	.	T	C	2	4	6	0	0	6	0	0
13	67967482	.	T	C	2	2	4	0	0	4	0	0
13	67967727	.	T	C	2	3	5	0	0	5	0	0
13	75793018	.	G	A	6	0	6	0	0	6	0	0
13	75793212	.	C	T	0	6	6	3	0	9	0	0
13	76209513	.	A	G	4	2	6	0	0	6	0	0
13	83887294	.	C	T	20	3	23	0	5	28	0	0
13	92032478	.	A	C	7	1	8	0	2	10	0	0
13	92521565	.	C	G	5	2	7	0	0	7	0	0
13	100202931	.	A	G	1	2	3	0	0	3	0	0
13	100839304	.	T	C	13	5	18	0	0	18	0	0
13	100839326	.	T	C	6	11	17	0	1	18	0	0
13	100839340	.	T	C	2	8	10	0	0	10	0	0
13	119625401	.	G	T	6	4	10	0	0	10	0	0
13	120230616	.	T	C	1	2	3	0	0	3	0	0
14	10058181	.	A	G	36	13	49	0	1	50	0	0
14	14533725	.	T	C	0	11	11	0	1	12	0	0
14	21846832	.	A	G	15	39	54	0	3	57	0	0
14	21846833	.	A	G	45	12	57	0	0	57	0	0
14	21847779	.	A	G	75	24	99	0	0	99	0	0
14	21847872	.	A	G	50	9	59	0	1	60	0	0
14	26381874	.	T	C	4	2	6	0	0	6	0	0
14	26381875	.	T	C	4	2	6	0	0	6	0	0
14	26382360	.	T	C	5	5	10	0	0	10	0	0
14	29788078	.	T	C	5	5	10	0	0	10	0	0
14	31422583	.	T	C	31	17	48	0	1	49	0	0
14	31422619	.	T	C	28	12	40	0	0	40	0	0
14	31423408	.	T	C	34	5	39	0	0	39	0	0
14	32018582	.	A	G	22	9	31	0	0	31	0	0
14	32993827	.	G	A	3	1	4	0	0	4	0	0
14	45832276	.	C	A	6	2	8	0	0	8	0	0
14	47558234	.	A	G	5	5	10	0	0	10	0	0
14	47972374	.	G	C	4	1	5	0	0	5	0	0
14	51013458	.	T	C	8	4	12	0	0	12	0	0
14	51109987	.	A	G	6	4	10	0	0	10	0	0
14	52243661	.	A	C	3	2	5	0	5	10	0	0
14	52243667	.	A	C	2	5	7	0	1	8	0	0
14	52435637	.	A	G	2	2	4	0	1	5	0	0
14	52531686	.	A	G	20	58	78	0	1	79	0	0
14	55094670	.	A	G	9	2	11	0	0	11	0	0
14	55658193	.	A	G	1	0	1	0	1	2	0	0
14	55749057	.	A	G	8	4	12	0	0	12	0	0
14	55787563	.	A	G	1	3	4	0	0	4	0	0
14	59883055	.	A	G	7	2	9	0	2	11	0	0
14	60451313	.	T	C	3	5	8	0	0	8	0	0
14	65434640	.	T	C	26	12	38	0	0	39	1	0
14	75957159	.	T	C	8	1	9	0	1	10	0	0
14	99552141	.	C	T	3	2	5	0	0	5	0	0
14	103583875	.	T	C	9	2	11	0	0	11	0	0
14	103584115	.	T	C	18	8	26	0	0	26	0	0
14	109148057	.	C	G	8	7	15	0	4	19	0	0
14	121273016	.	A	G	3	3	6	0	0	6	0	0
15	3348888	.	C	A	4	1	5	0	1	6	0	0
15	8187674	.	A	G	11	9	20	0	0	20	0	0
15	8187696	.	A	G	11	3	14	0	1	15	0	0
15	8188973	.	A	G	5	4	9	0	2	11	0	0
15	9199559	.	A	G	31	16	47	0	4	51	0	0
15	11840860	.	A	G	5	2	7	0	0	7	0	0
15	12809789	.	T	C	35	7	42	0	2	44	0	0
15	55116094	.	A	G	9	2	11	0	0	11	0	0
15	75525421	.	T	C	2	3	5	0	1	6	0	0
15	79133222	.	G	A	14	15	29	0	1	30	0	0
15	79496070	.	T	C	4	3	7	0	0	7	0	0
15	80816550	.	A	G	4	5	9	0	0	9	0	0
15	81339166	.	A	G	10	6	16	0	0	16	0	0
15	81791419	.	A	G	4	2	6	0	0	6	0	0
15	82015818	.	A	G	2	3	5	0	0	5	0	0
15	84836683	.	T	C	7	3	10	0	0	10	0	0
15	98634993	.	T	C	17	33	50	0	1	51	0	0
15	98731431	.	T	C	22	6	28	0	0	28	0	0
15	98935173	.	C	T	2	4	6	1	0	7	0	0
15	99142536	.	T	C	2	1	3	0	0	3	0	0
15	99626051	.	A	G	7	4	11	0	0	11	0	0
15	99626091	.	A	G	6	1	7	0	0	7	0	0
15	99627261	.	A	G	1	3	4	0	0	4	0	0
15	99627262	.	A	G	2	2	4	0	0	4	0	0
16	4444275	.	T	C	2	2	4	0	0	4	0	0
16	4444284	.	T	C	3	2	5	0	0	5	0	0
16	8507493	.	C	T	15	4	19	0	0	19	0	0
16	8514085	.	A	G	2	2	4	0	0	4	0	0
16	13283445	.	A	G	1	2	3	0	0	3	0	0
16	13520445	.	A	G	17	5	22	0	0	22	0	0
16	13520501	.	A	G	8	2	10	0	0	10	0	0
16	13576064	.	A	G	1	2	3	0	0	3	0	0
16	13631815	.	C	T	18	4	22	0	0	22	0	0
16	13650452	.	A	G	7	3	10	0	0	10	0	0
16	13651947	.	T	C	23	5	28	0	2	30	0	0
16	13927109	.	T	C	4	7	11	0	10	21	0	0
16	13927112	.	A	C	5	2	7	0	15	22	0	0
16	16844849	.	A	G	4	4	8	0	0	8	0	0
16	16844860	.	A	G	5	3	8	0	0	8	0	0
16	17321752	.	A	G	13	4	17	0	0	17	0	0
16	18653678	.	A	G	38	20	58	0	2	60	0	0
16	19942498	.	A	G	37	27	64	0	1	65	0	0
16	20508413	.	A	G	5	2	7	0	0	7	0	0
16	30330773	.	T	C	10	3	13	0	0	13	0	0
16	32118665	.	A	G	16	7	23	0	1	24	0	0
16	32119106	.	A	G	22	10	32	0	2	34	0	0
16	32119150	.	A	G	21	12	33	0	0	33	0	0
16	32209076	.	C	T	8	2	10	0	2	12	0	0
16	57131671	.	A	G	9	2	11	0	1	12	0	0
16	72842228	.	G	T	17	3	20	0	3	23	0	0
16	78133495	.	A	G	3	2	5	0	0	5	0	0
16	87230813	.	T	C	10	2	12	0	0	12	0	0
16	87230814	.	T	C	9	3	12	0	0	12	0	0
16	87737431	.	T	C	1	1	2	0	0	2	0	0
16	91287590	.	A	G	2	2	4	0	0	4	0	0
16	91452503	.	A	G	85	15	100	0	4	104	0	0
16	91452977	.	A	G	59	34	93	0	0	93	0	0
16	91453021	.	A	G	73	16	89	0	1	90	0	0
16	92336842	.	C	T	9	2	11	0	1	12	0	0
16	97658408	.	T	C	3	3	6	0	0	6	0	0
17	10429111	.	C	T	2	2	4	0	0	4	0	0
17	15695793	.	T	C	4	2	6	0	0	6	0	0
17	15741073	.	A	G	5	4	9	0	0	9	0	0
17	15742534	.	A	G	2	2	4	0	0	4	0	0
17	18132829	.	C	T	1	0	1	0	0	1	0	0
17	24395416	.	T	C	53	12	65	0	0	65	0	0
17	24395428	.	T	C	48	23	71	0	0	71	0	0
17	24397285	.	T	C	20	21	41	0	0	41	0	0
17	24397327	.	T	C	8	14	22	0	1	23	0	0
17	24635698	.	A	G	5	4	9	0	0	9	0	0
17	24635786	.	A	G	8	2	10	0	1	11	0	0
17	27721769	.	T	C	7	3	10	0	0	10	0	0
17	28392510	.	C	T	1	2	3	0	0	3	0	0
17	29521001	.	A	G	5	4	9	0	1	10	0	0
17	29919711	.	G	T	2	4	6	0	0	6	0	0
17	32063514	.	C	A	0	3	3	0	1	4	0	0
17	32281461	.	G	A	7	2	9	0	0	9	0	0
17	32992239	.	G	T	5	4	9	0	1	10	0	0
17	33015107	.	T	C	4	2	6	0	0	6	0	0
17	33015482	.	T	C	14	3	17	0	0	17	0	0
17	33034548	.	T	C	13	2	15	0	0	15	0	0
17	33034549	.	T	C	10	5	15	0	0	15	0	0
17	33552004	.	T	C	9	4	13	0	0	13	0	0
17	33867517	.	T	C	4	2	6	0	0	6	0	0
17	34147531	.	A	G	12	11	23	0	1	24	0	0
17	36168626	.	A	G	4	5	9	0	0	9	0	0
17	36317333	.	T	C	12	2	14	0	0	14	0	0
17	40158498	.	T	C	3291	4640	7931	0	123	8470	416	0
17	45973875	.	T	C	14	28	42	0	6	48	0	0
17	46727251	.	A	G	4	5	9	0	0	9	0	0
17	46765496	.	G	A	5	5	10	0	2	12	0	0
17	46810304	.	A	G	4	4	8	0	0	8	0	0
17	47085856	.	T	C	15	9	24	0	0	24	0	0
17	47085857	.	T	C	12	12	24	0	0	24	0	0
17	50586902	.	G	A	3	3	6	0	0	6	0	0
17	62088129	.	T	C	0	3	3	0	0	3	0	0
17	63806215	.	T	C	11	3	14	0	0	14	0	0
17	72016580	.	C	T	4	0	4	0	0	4	0	0
17	78682975	.	G	T	6	2	8	0	0	8	0	0
17	87386211	.	G	A	0	1	1	2	2	5	0	0
17	88797008	.	G	T	5	3	8	0	0	8	0	0
17	88797009	.	C	T	5	3	8	0	0	8	0	0
17	95064364	.	T	C	6	4	10	0	0	10	0	0
17	95067396	.	T	C	9	10	19	0	0	19	0	0
17	95067479	.	T	C	11	10	21	0	1	22	0	0
17	95068514	.	T	C	24	3	27	0	0	27	0	0
17	95068552	.	T	C	35	7	42	0	0	42	0	0
17	95123375	.	T	C	1	2	3	0	0	3	0	0
18	4198525	.	T	C	2	1	3	0	0	3	0	0
18	6792757	.	A	G	14	5	19	0	2	21	0	0
18	6792802	.	A	G	13	5	18	0	0	18	0	0
18	6793749	.	A	G	15	4	19	0	0	19	0	0
18	6793776	.	A	G	14	4	18	0	0	18	0	0
18	10813843	.	A	G	80	14	94	0	2	96	0	0
18	24097917	.	A	G	7	5	12	0	0	12	0	0
18	24639050	.	T	C	8	2	10	0	0	10	0	0
18	32235557	.	A	G	5	7	12	0	0	12	0	0
18	32235595	.	A	G	2	14	16	0	0	16	0	0
18	32235652	.	A	G	3	10	13	0	0	13	0	0
18	32235930	.	A	G	2	5	7	0	0	7	0	0
18	32236019	.	A	G	6	4	10	0	0	10	0	0
18	32561134	.	A	G	27	16	43	0	0	43	0	0
18	35743341	.	A	G	11	2	13	0	0	13	0	0
18	35935410	.	A	G	5	3	8	0	0	8	0	0
18	38596909	.	A	G	3	1	4	0	0	4	0	0
18	46869696	.	T	C	6	2	8	0	0	8	0	0
18	55031875	.	T	C	8	2	10	0	0	10	0	0
18	57089576	.	T	C	2	7	9	0	1	10	0	0
18	57090006	.	T	C	11	4	15	0	0	15	0	0
18	59543586	.	A	T	5	2	7	0	0	7	0	0
18	65610148	.	A	G	4	2	6	0	0	6	0	0
18	69821991	.	A	C	26	7	33	0	4	37	0	0
18	77062550	.	A	G	11	17	28	0	0	28	0	0
18	80335838	.	T	A	2	1	3	0	5	8	0	0
19	4367848	.	C	T	16	4	20	0	6	26	0	0
19	4811133	.	T	C	7	3	10	0	1	11	0	0
19	4937709	.	T	C	19	4	23	0	0	23	0	0
19	4937728	.	T	C	18	4	22	0	0	22	0	0
19	4938525	.	A	T	4	4	8	0	0	8	0	0
19	5015429	.	A	G	2	2	4	0	0	4	0	0
19	7515480	.	A	G	17	5	22	0	0	22	0	0
19	8816897	.	A	C	7	7	14	0	2	16	0	0
19	8868253	.	A	G	8	1	9	0	0	9	0	0
19	8868268	.	A	G	4	3	7	0	0	7	0	0
19	8900145	.	A	G	1	6	7	0	0	7	0	0
19	10223060	.	T	C	26	56	82	0	2	84	0	0
19	10512634	.	A	C	14	6	20	0	2	22	0	0
19	10885930	.	A	G	2	3	5	0	0	5	0	0
19	10886122	.	A	G	3	2	5	0	0	5	0	0
19	10886159	.	A	G	2	2	4	0	0	4	0	0
19	12441626	.	A	G	29	5	34	0	0	34	0	0
19	40905972	.	G	T	5	1	6	0	1	7	0	0
19	42244238	.	G	C	12	4	16	0	7	23	0	0
19	42244242	.	G	C	13	3	16	0	6	22	0	0
19	43429601	.	A	G	14	15	29	0	0	30	1	0
19	43429753	.	A	G	29	8	37	0	0	37	0	0
19	44993669	.	T	C	29	8	37	0	1	38	0	0
19	46269407	.	A	G	1	2	3	0	0	3	0	0
19	46584105	.	A	G	1	2	3	0	0	3	0	0
19	46584110	.	A	G	2	1	3	0	0	3	0	0
19	46584812	.	A	G	2	3	5	0	0	5	0	0
19	46584822	.	A	G	4	2	6	0	0	6	0	0
2	3508326	.	A	C	4	2	6	0	0	6	0	0
2	5902865	.	T	C	2	2	4	0	0	4	0	0
2	10261256	.	C	T	5	2	7	0	0	7	0	0
2	14153492	.	A	G	1	10	11	0	0	11	0	0
2	14153493	.	A	G	1	10	11	0	0	11	0	0
2	14153560	.	A	G	5	10	15	0	0	15	0	0
2	14153568	.	A	G	9	8	17	0	0	17	0	0
2	18219539	.	T	C	5	5	10	0	0	10	0	0
2	18219544	.	T	C	7	3	10	0	0	10	0	0
2	22479057	.	T	C	0	1	1	0	0	1	0	0
2	22479348	.	G	A	9	9	18	7	40	65	0	0
2	25597684	.	T	A	7	2	9	0	0	9	0	0
2	25597686	.	C	A	7	2	9	0	0	9	0	0
2	26271752	.	A	G	2	2	4	0	0	4	0	0
2	26271758	.	A	G	2	2	4	0	0	4	0	0
2	26846568	.	T	C	4	2	6	0	0	6	0	0
2	26848217	.	T	C	6	3	9	0	0	9	0	0
2	29142459	.	G	T	1	1	2	0	0	2	0	0
2	29961700	.	C	T	7	15	22	7	4	33	0	0
2	30174243	.	A	T	4	4	8	0	0	8	0	0
2	30920955	.	T	C	28	5	33	0	1	34	0	0
2	31040896	.	T	C	1	2	3	0	0	3	0	0
2	31505906	.	A	G	13	2	15	0	0	15	0	0
2	31506608	.	C	T	6	2	8	0	3	11	0	0
2	31506610	.	G	T	8	2	10	0	1	11	0	0
2	32174582	.	T	C	5	2	7	0	0	7	0	0
2	32911428	.	T	C	1	4	5	0	0	5	0	0
2	32911454	.	T	C	2	2	4	0	0	4	0	0
2	38902454	.	A	G	3	2	5	0	0	5	0	0
2	40445910	.	G	T	0	3	3	3	1	7	0	0
2	52318355	.	C	T	5	2	7	0	1	8	0	0
2	52318356	.	A	T	5	0	5	0	3	8	0	0
2	52321031	.	A	T	14	3	17	0	3	20	0	0
2	52321032	.	G	T	15	3	18	0	2	20	0	0
2	55005781	.	C	T	13	2	15	0	0	15	0	0
2	55005783	.	G	T	13	2	15	0	0	15	0	0
2	59185548	.	G	A	0	2	2	0	0	2	0	0
2	59185550	.	G	A	0	2	2	0	0	2	0	0
2	66314260	.	G	C	0	3	3	0	0	3	0	0
2	66314290	.	A	C	0	3	3	0	1	4	0	0
2	76427859	.	G	C	7	2	9	0	10	19	0	0
2	76427865	.	G	C	9	3	12	0	8	20	0	0
2	76428783	.	A	C	10	3	13	0	7	20	0	0
2	76428789	.	A	C	10	4	14	0	4	18	0	0
2	80668540	.	G	A	0	3	3	3	2	8	0	0
2	83636894	.	G	T	5	2	7	0	0	7	0	0
2	83711742	.	C	A	62	46	108	0	2	110	0	0
2	90263321	.	G	A	2	5	7	0	2	9	0	0
2	90263322	.	C	A	0	1	1	0	8	9	0	0
2	90728419	.	T	C	8	2	10	0	0	10	0	0
2	91043632	.	A	G	38	11	49	0	0	49	0	0
2	91064743	.	T	C	9	3	12	0	0	12	0	0
2	91551466	.	A	G	9	2	11	0	1	12	0	0
2	102612558	.	T	A	9	57	66	0	10	76	0	0
2	104511430	.	T	C	13	4	17	0	0	17	0	0
2	112185846	.	A	G	2	4	6	0	0	6	0	0
2	112185852	.	A	G	4	2	6	0	0	6	0	0
2	114347125	.	G	T	1	2	3	0	0	3	0	0
2	114347126	.	G	T	1	0	1	0	2	3	0	0
2	117173318	.	C	A	96	56	152	0	1	153	0	0
2	118700801	.	A	G	11	3	14	0	0	14	0	0
2	119128835	.	T	C	2	2	4	0	1	5	0	0
2	120564258	.	T	C	22	26	48	0	0	48	0	0
2	120564286	.	T	C	36	9	45	0	0	45	0	0
2	120564302	.	T	C	24	19	43	0	3	46	0	0
2	120988975	.	A	G	4	2	6	0	0	6	0	0
2	121015462	.	A	G	1	3	4	0	0	4	0	0
2	121374228	.	A	G	3	4	7	0	0	7	0	0
2	122199390	.	T	C	10	2	12	0	3	15	0	0
2	122199409	.	C	G	4	2	6	0	5	11	0	0
2	126733408	.	T	C	10	5	15	0	0	15	0	0
2	126733420	.	T	C	13	3	16	0	0	16	0	0
2	126734766	.	T	C	2	4	6	0	3	9	0	0
2	126734771	.	T	C	5	2	7	0	0	7	0	0
2	126734836	.	T	C	11	5	16	0	2	18	0	0
2	130396876	.	A	G	3	5	8	0	0	8	0	0
2	130397819	.	A	G	11	2	13	0	0	13	0	0
2	130397909	.	A	G	3	3	6	0	0	6	0	0
2	130397973	.	A	G	1	5	6	0	0	6	0	0
2	130397974	.	A	G	2	4	6	0	0	6	0	0
2	132151800	.	A	G	34	298	332	0	7	339	0	0
2	132636996	.	C	A	3	3	6	0	0	6	0	0
2	132708131	.	G	T	15	3	18	0	4	22	0	0
2	136913796	.	T	C	2	2	4	0	0	4	0	0
2	140501239	.	C	T	7	7	14	0	2	16	0	0
2	144381830	.	A	G	11	4	15	0	0	15	0	0
2	149585919	.	C	T	0	3	3	0	0	3	0	0
2	152114942	.	A	G	3	8	11	0	0	11	0	0
2	153108492	.	A	G	15	3	18	0	0	18	0	0
2	153460309	.	T	C	2	7	9	0	0	9	0	0
2	153460310	.	T	C	5	4	9	0	0	9	0	0
2	154379850	.	A	G	31	9	40	0	0	40	0	0
2	155980520	.	T	C	2	3	5	0	0	5	0	0
2	157313041	.	A	C	10	10	20	0	7	27	0	0
2	157400060	.	T	C	85	21	106	0	5	111	0	0
2	157400069	.	T	C	77	31	108	0	1	109	0	0
2	158220838	.	A	G	11	8	19	0	1	20	0	0
2	158226873	.	A	G	90	325	415	0	21	436	0	0
2	163309459	.	T	C	9	15	24	0	0	24	0	0
2	163310345	.	T	C	31	7	38	0	0	38	0	0
2	164266227	.	T	A	0	0	0	0	2	2	0	0
2	164306821	.	G	A	13	9	22	0	5	27	0	0
2	164953773	.	T	C	33	11	44	0	0	44	0	0
2	168055230	.	T	C	1	2	3	0	1	4	0	0
2	169913325	.	A	G	3	5	8	0	0	8	0	0
2	169913421	.	A	G	7	6	13	0	1	14	0	0
2	174169694	.	A	G	60	24	84	0	0	84	0	0
2	174548497	.	C	T	7	3	10	0	3	13	0	0
2	176411921	.	A	T	8	3	11	0	0	11	0	0
2	177673966	.	T	C	13	2	15	0	0	15	0	0
3	9494242	.	T	C	5	2	7	0	5	12	0	0
3	9494248	.	G	C	5	3	8	0	5	13	0	0
3	10406523	.	T	C	2	2	4	0	0	4	0	0
3	18111642	.	T	A	7	2	9	0	0	10	1	0
3	19278361	.	T	C	2	2	4	0	0	4	0	0
3	26385911	.	T	C	15	3	18	0	0	18	0	0
3	32393742	.	T	G	12	4	16	2	2	20	0	0
3	32615620	.	A	G	20	3	23	0	0	23	0	0
3	32615624	.	C	T	20	7	27	0	1	28	0	0
3	32636549	.	T	C	12	9	21	0	0	21	0	0
3	36146600	.	A	G	2	2	4	0	0	4	0	0
3	40747624	.	A	G	31	10	41	0	0	41	0	0
3	40747629	.	A	G	27	14	41	0	1	42	0	0
3	40748697	.	A	G	42	8	50	0	0	50	0	0
3	45389662	.	C	T	5	1	6	0	1	7	0	0
3	45389665	.	C	T	6	1	7	0	1	8	0	0
3	57551841	.	T	C	1	2	3	0	0	3	0	0
3	57553351	.	T	C	2	3	5	0	0	5	0	0
3	63929640	.	T	A	3	2	5	0	0	5	0	0
3	65866372	.	A	G	3	2	5	0	0	5	0	0
3	65868019	.	A	G	6	2	8	0	0	8	0	0
3	68533367	.	C	T	27	14	41	0	21	62	0	0
3	68901450	.	T	C	3	2	5	0	0	5	0	0
3	68901456	.	T	C	0	2	2	0	0	2	0	0
3	80599593	.	T	C	4	45	49	0	1	50	0	0
3	80614159	.	T	C	7	9	16	0	0	16	0	0
3	80614215	.	T	C	99	34	133	0	3	136	0	0
3	88238210	.	A	G	0	2	2	0	0	2	0	0
3	88259488	.	A	G	2	4	6	0	0	6	0	0
3	88259498	.	A	G	1	6	7	0	0	7	0	0
3	88259542	.	A	G	10	3	13	0	0	13	0	0
3	88259584	.	A	G	4	3	7	0	0	7	0	0
3	88259907	.	A	G	1	3	4	0	0	4	0	0
3	89675221	.	T	C	10	2	12	0	0	12	0	0
3	89675614	.	T	C	4	5	9	0	0	9	0	0
3	89967705	.	A	G	0	3	3	0	0	3	0	0
3	89967924	.	A	G	2	6	8	0	1	9	0	0
3	89967938	.	A	G	5	3	8	0	0	8	0	0
3	93353627	.	A	T	8	0	8	0	0	8	0	0
3	93353631	.	C	A	8	0	8	0	0	8	0	0
3	94311127	.	G	A	3	2	5	0	0	5	0	0
3	94794244	.	T	A	10	2	12	0	0	12	0	0
3	94794245	.	G	A	10	2	12	0	0	12	0	0
3	96127814	.	A	G	1	3	4	0	0	4	0	0
3	96539776	.	A	G	2	21	23	0	1	24	0	0
3	96540029	.	A	G	17	5	22	0	1	23	0	0
3	101346949	.	T	C	3	1	4	0	0	4	0	0
3	101483703	.	G	C	23	10	33	0	26	59	0	0
3	102973406	.	A	G	32	12	44	0	2	46	0	0
3	104835352	.	A	G	5	4	9	0	0	9	0	0
3	105634359	.	A	G	1	2	3	0	1	4	0	0
3	116537746	.	T	C	15	5	20	0	1	21	0	0
3	116537808	.	T	C	11	5	16	0	0	16	0	0
3	135112631	.	T	C	50	9	59	0	0	59	0	0
3	146435333	.	A	T	0	5	5	0	0	5	0	0
4	10989135	.	C	A	2	2	4	0	0	4	0	0
4	21869677	.	A	T	12	3	15	0	5	20	0	0
4	21911667	.	A	G	10	5	15	0	0	15	0	0
4	21911675	.	A	G	12	6	18	0	0	18	0	0
4	21911872	.	A	G	9	2	11	0	0	11	0	0
4	21911886	.	A	G	12	3	15	0	0	15	0	0
4	21996098	.	A	C	18	6	24	0	2	26	0	0
4	33019420	.	A	G	76	19	95	0	1	96	0	0
4	33020417	.	A	G	56	60	116	0	1	117	0	0
4	33945697	.	T	C	35	36	71	0	1	72	0	0
4	41518514	.	T	C	177	32	209	0	4	213	0	0
4	43664077	.	G	C	3	0	3	0	0	3	0	0
4	55081616	.	C	A	6	4	10	0	1	11	0	0
4	55385495	.	G	A	4	1	5	0	0	5	0	0
4	56870216	.	T	C	5	2	7	0	0	7	0	0
4	56870260	.	T	C	3	5	8	0	1	9	0	0
4	56875812	.	T	C	3	2	5	0	0	5	0	0
4	57143018	.	T	C	5	2	7	0	0	7	0	0
4	86495344	.	G	T	50	15	65	0	3	69	1	0
4	103021909	.	A	G	15	5	20	0	1	21	0	0
4	106298400	.	A	C	14	5	19	0	0	19	0	0
4	108198313	.	A	G	3	3	6	0	1	7	0	0
4	108690513	.	T	C	8	2	10	0	0	10	0	0
4	116409401	.	T	C	4	2	6	0	0	6	0	0
4	118484005	.	A	G	10	18	28	0	0	28	0	0
4	119080668	.	T	C	5	5	10	0	0	10	0	0
4	119135361	.	C	T	23	32	55	1	16	72	0	0
4	121003224	.	A	G	5	2	7	0	0	7	0	0
4	124832762	.	A	G	2	2	4	0	0	4	0	0
4	124832765	.	A	G	1	3	4	0	0	4	0	0
4	124838094	.	A	G	13	9	22	0	1	23	0	0
4	124838166	.	A	G	15	4	19	0	0	19	0	0
4	124838169	.	A	G	12	6	18	0	0	18	0	0
4	125982944	.	A	G	8	7	15	0	1	16	0	0
4	125982950	.	A	G	8	4	12	0	0	12	0	0
4	125982989	.	A	G	8	2	10	0	0	10	0	0
4	125984993	.	A	G	5	2	7	0	3	10	0	0
4	125985065	.	A	G	6	4	10	0	1	11	0	0
4	125985112	.	A	G	9	4	13	0	0	13	0	0
4	129586229	.	C	T	2	2	4	0	0	4	0	0
4	131679966	.	T	C	17	4	21	0	1	22	0	0
4	135483725	.	A	G	0	3	3	0	0	3	0	0
4	137987341	.	A	G	56	18	74	0	0	74	0	0
4	137987354	.	A	G	49	24	73	0	1	74	0	0
4	138184300	.	A	G	0	3	3	0	0	3	0	0
4	139376720	.	A	C	8	1	9	0	6	15	0	0
4	139376726	.	A	C	8	2	10	0	6	16	0	0
4	144314687	.	A	G	4	1	5	0	0	5	0	0
4	147907770	.	T	C	2	2	4	0	0	4	0	0
4	147909430	.	T	C	7	4	11	0	0	11	0	0
4	148140817	.	A	G	12	3	15	0	0	15	0	0
4	149202586	.	A	G	30	9	39	0	2	41	0	0
4	149203211	.	A	G	9	5	14	0	1	15	0	0
4	149552635	.	T	C	3	5	8	0	2	10	0	0
4	154049751	.	G	A	5	2	7	0	1	8	0	0
4	155800938	.	A	G	5	4	9	0	0	9	0	0
4	155800977	.	A	G	8	2	10	0	0	10	0	0
4	156095123	.	A	G	73	42	115	0	1	116	0	0
4	156105048	.	T	C	6	3	9	0	0	9	0	0
4	156105693	.	T	C	9	7	16	0	0	16	0	0
5	23945753	.	A	G	6	2	8	0	0	8	0	0
5	24649635	.	T	C	22	4	26	0	2	28	0	0
5	24649804	.	T	C	12	17	29	0	0	29	0	0
5	25894974	.	G	A	5	1	6	0	0	6	0	0
5	25897453	.	A	T	5	1	6	0	2	8	0	0
5	29658129	.	A	G	1	2	3	0	0	3	0	0
5	30780828	.	G	A	1	1	2	0	5	7	0	0
5	31330824	.	T	C	3	4	7	0	0	7	0	0
5	33149571	.	A	G	5	3	8	0	0	8	0	0
5	33573262	.	A	G	7	5	12	0	0	12	0	0
5	33573281	.	A	G	6	5	11	0	0	11	0	0
5	33573900	.	A	G	6	3	9	0	0	9	0	0
5	36157689	.	C	T	5	2	7	0	1	8	0	0
5	36157699	.	C	T	5	1	6	0	1	7	0	0
5	54155989	.	A	C	2	4	6	0	1	8	1	0
5	65605388	.	T	C	57	16	73	0	2	75	0	0
5	65605389	.	T	C	38	33	71	0	4	75	0	0
5	73469787	.	A	G	71	13	84	0	0	84	0	0
5	77555578	.	T	C	3	11	14	0	0	15	1	0
5	88904267	.	C	T	8	4	12	0	4	16	0	0
5	88906486	.	C	T	4	3	7	0	0	7	0	0
5	96413280	.	G	T	4	1	5	0	3	8	0	0
5	96413281	.	A	T	5	1	6	0	2	8	0	0
5	104652843	.	A	G	16	7	23	0	0	23	0	0
5	104652845	.	A	G	16	7	23	0	0	23	0	0
5	113235693	.	T	C	4	17	21	0	0	21	0	0
5	113235700	.	T	C	11	18	29	0	0	29	0	0
5	113873957	.	A	C	2	1	3	0	3	6	0	0
5	114894305	.	T	C	0	1	1	0	0	1	0	0
5	115434850	.	G	A	11	2	13	0	1	14	0	0
5	115483707	.	A	G	4	2	6	0	0	6	0	0
5	117343472	.	A	G	1	2	3	0	0	3	0	0
5	117343491	.	A	G	1	2	3	0	0	3	0	0
5	121581241	.	T	C	2	2	4	0	0	4	0	0
5	121941595	.	A	G	2	3	5	0	0	5	0	0
5	121943596	.	A	G	1	3	4	0	0	4	0	0
5	122546790	.	A	G	11	2	13	0	0	13	0	0
5	123386729	.	A	G	18	11	29	0	0	29	0	0
5	123879315	.	T	C	4	5	9	0	0	9	0	0
5	123879325	.	T	C	3	2	5	0	0	5	0	0
5	123879350	.	T	C	5	3	8	0	0	8	0	0
5	123880062	.	T	C	2	2	4	0	0	4	0	0
5	125533669	.	A	G	18	63	81	0	4	85	0	0
5	125533687	.	A	G	60	20	80	0	2	82	0	0
5	125534541	.	A	G	49	22	71	0	0	71	0	0
5	129797823	.	A	G	5	17	22	0	0	22	0	0
5	129892662	.	A	G	16	3	19	0	0	19	0	0
5	130019253	.	A	G	1	2	3	0	0	3	0	0
5	130019272	.	A	G	3	1	4	0	0	4	0	0
5	131466449	.	C	T	4	3	7	0	7	14	0	0
5	134192591	.	C	T	8	1	9	0	0	9	0	0
5	135192126	.	A	G	8	2	10	0	0	10	0	0
5	135402657	.	A	G	1	2	3	0	0	3	0	0
5	136941953	.	A	G	77	20	97	0	0	97	0	0
5	137525546	.	G	T	6	3	9	0	1	10	0	0
5	140510846	.	A	C	8	4	12	0	2	14	0	0
5	140510852	.	G	C	14	4	18	0	0	18	0	0
5	140606802	.	T	G	17	4	21	0	11	32	0	0
5	142655047	.	A	G	71	24	95	0	1	96	0	0
5	142855980	.	T	C	0	3	3	0	0	3	0	0
5	142855997	.	T	C	0	0	0	0	1	1	0	0
5	143381709	.	A	G	7	2	9	0	0	9	0	0
5	143382034	.	A	G	8	2	10	0	0	10	0	0
5	143382050	.	A	G	3	7	10	0	0	10	0	0
5	143382388	.	A	G	3	4	7	0	0	7	0	0
5	143382882	.	A	G	6	2	8	0	0	8	0	0
5	143751066	.	A	G	8	3	11	0	0	11	0	0
5	143883169	.	A	G	0	1	1	0	0	1	0	0
5	148985213	.	G	A	5	7	12	2	8	22	0	0
5	150561734	.	T	C	8	2	10	0	0	10	0	0
6	17990026	.	C	T	1	1	2	0	0	2	0	0
6	18145017	.	T	C	0	2	2	0	0	2	0	0
6	18429956	.	G	A	1	8	9	0	1	10	0	0
6	18430049	.	T	C	1	12	13	0	0	13	0	0
6	31486635	.	A	C	8	3	11	0	2	13	0	0
6	31486641	.	G	C	12	2	14	0	2	16	0	0
6	31492600	.	A	G	13	3	16	0	3	19	0	0
6	31492602	.	A	G	9	8	17	0	2	19	0	0
6	34751192	.	A	C	11	3	14	0	1	15	0	0
6	34751198	.	A	C	8	4	12	0	1	13	0	0
6	34854609	.	A	G	9	2	11	0	1	12	0	0
6	37847782	.	A	G	5	6	11	0	1	12	0	0
6	38265837	.	T	C	7	2	9	0	0	9	0	0
6	39312088	.	T	C	16	7	23	0	1	24	0	0
6	47844733	.	C	T	5	2	7	0	0	7	0	0
6	47848259	.	A	G	11	3	14	0	0	14	0	0
6	47848294	.	A	G	9	2	11	0	0	11	0	0
6	47848366	.	A	G	9	2	11	0	0	11	0	0
6	47848373	.	A	G	4	3	7	0	0	7	0	0
6	47849226	.	A	G	2	3	5	0	0	5	0	0
6	48375235	.	A	G	1	4	5	0	0	5	0	0
6	49233358	.	T	C	3	3	6	0	1	7	0	0
6	49233394	.	T	C	6	3	9	0	0	9	0	0
6	49237899	.	T	C	13	5	18	0	0	18	0	0
6	49237955	.	T	C	11	3	14	0	0	14	0	0
6	49237956	.	T	C	11	3	14	0	0	14	0	0
6	61288779	.	C	T	1	10	11	0	0	11	0	0
6	61288787	.	G	A	1	12	13	0	0	13	0	0
6	65684442	.	A	G	1	5	6	0	0	6	0	0
6	65687724	.	A	G	2	3	5	0	0	5	0	0
6	66517065	.	A	G	5	4	9	0	0	9	0	0
6	66517110	.	A	G	5	4	9	0	0	9	0	0
6	66517196	.	A	G	2	4	6	0	0	6	0	0
6	66517254	.	A	G	5	2	7	0	0	7	0	0
6	66517625	.	A	G	8	6	14	0	0	14	0	0
6	66517775	.	A	G	14	3	17	0	0	17	0	0
6	67273501	.	A	G	5	4	9	0	0	9	0	0
6	70743250	.	G	T	8	2	10	0	1	11	0	0
6	71791046	.	T	C	6	2	8	0	0	8	0	0
6	86391922	.	A	G	2	2	4	0	0	4	0	0
6	87067469	.	A	T	1	7	8	0	0	8	0	0
6	87113982	.	G	C	0	7	7	0	0	7	0	0
6	87113983	.	T	C	0	7	7	0	0	7	0	0
6	87791772	.	T	C	5	3	8	0	0	8	0	0
6	87791783	.	T	C	5	2	7	0	0	7	0	0
6	87795142	.	T	C	9	3	12	0	0	12	0	0
6	89293495	.	T	G	11	8	19	0	8	27	0	0
6	91880140	.	A	G	1	2	3	0	0	3	0	0
6	96010042	.	T	C	2	3	5	1	1	7	0	0
6	99497627	.	C	T	4	3	7	1	0	8	0	0
6	115229054	.	G	A	0	2	2	0	0	2	0	0
6	115229055	.	C	A	0	0	0	0	2	2	0	0
6	118478591	.	C	T	0	13	13	0	0	13	0	0
6	118483481	.	T	A	5	1	6	0	0	6	0	0
6	118500305	.	C	T	1	7	8	0	0	8	0	0
6	118500320	.	A	G	1	5	6	0	2	8	0	0
6	118566170	.	T	C	6	6	12	0	1	13	0	0
6	118566174	.	C	T	10	4	14	0	0	15	1	0
6	118566344	.	A	G	1	5	6	0	0	6	0	0
6	119194385	.	A	G	0	5	5	0	0	5	0	0
6	120743411	.	C	T	0	5	5	0	0	5	0	0
6	120746026	.	A	G	1	2	3	0	0	3	0	0
6	122715481	.	T	C	2	2	4	0	0	4	0	0
6	124787015	.	A	G	2	5	7	0	0	7	0	0
6	124787022	.	T	G	1	5	6	0	0	6	0	0
6	124787056	.	A	C	2	2	4	0	0	4	0	0
6	125171627	.	A	G	4	2	6	0	0	6	0	0
6	125217465	.	A	G	4	2	6	0	0	6	0	0
6	126619121	.	T	C	62	33	95	0	2	97	0	0
6	134517979	.	G	T	5	1	6	0	3	9	0	0
6	134518327	.	C	G	9	2	11	0	0	11	0	0
6	142534776	.	T	C	5	2	7	0	0	7	0	0
6	146733792	.	A	G	2	2	4	0	0	4	0	0
7	3386270	.	A	G	4	3	7	0	0	7	0	0
7	3463600	.	A	G	95	15	110	0	5	115	0	0
7	4899732	.	A	G	4	2	6	0	0	6	0	0
7	6357880	.	A	G	2	3	5	0	0	5	0	0
7	6357928	.	A	G	4	2	6	0	0	6	0	0
7	6358535	.	A	G	7	2	9	0	0	9	0	0
7	6433526	.	A	G	15	5	20	0	0	20	0	0
7	6678646	.	T	C	1	5	6	0	0	6	0	0
7	6967909	.	A	G	10	9	19	0	0	19	0	0
7	6967915	.	A	G	15	5	20	0	0	20	0	0
7	6968013	.	A	G	7	4	11	0	0	11	0	0
7	6968063	.	T	G	3	8	11	0	1	12	0	0
7	6969513	.	A	G	10	21	31	0	0	31	0	0
7	6969571	.	C	T	0	11	11	0	1	12	0	0
7	12212392	.	A	G	8	3	11	0	0	11	0	0
7	12706135	.	A	G	5	2	7	0	0	7	0	0
7	12706157	.	A	G	6	5	11	0	0	11	0	0
7	12707543	.	A	G	4	2	6	0	0	6	0	0
7	12707548	.	A	G	2	3	5	0	0	5	0	0
7	15864164	.	G	C	2	2	4	0	2	6	0	0
7	15864170	.	T	C	2	2	4	0	2	6	0	0
7	15887215	.	C	T	0	32	32	0	2	34	0	0
7	16348719	.	C	G	1	6	7	0	0	7	0	0
7	16348726	.	G	A	1	2	3	0	0	3	0	0
7	16515475	.	T	A	2	4	6	0	0	6	0	0
7	16589769	.	A	G	0	1	1	0	0	1	0	0
7	16619272	.	A	G	7	41	48	0	0	48	0	0
7	16619450	.	A	G	10	2	12	0	0	12	0	0
7	16619714	.	A	G	61	20	81	0	2	83	0	0
7	16649396	.	A	T	232	30	262	0	29	291	0	0
7	16650306	.	C	G	8	16	24	0	5	29	0	0
7	16651118	.	A	G	0	595	595	0	9	604	0	0
7	16728876	.	G	C	0	4	4	0	0	4	0	0
7	18873733	.	T	C	5	3	8	0	0	8	0	0
7	18874314	.	T	C	14	3	17	0	0	17	0	0
7	19638449	.	T	A	2	6	8	0	0	8	0	0
7	19638461	.	T	A	2	3	5	0	0	5	0	0
7	23840812	.	T	C	0	5	5	6	0	11	0	0
7	23933876	.	G	A	0	2	2	0	0	2	0	0
7	23974961	.	C	T	1	3	4	0	0	4	0	0
7	23974988	.	C	T	1	6	7	0	0	7	0	0
7	23975018	.	G	A	1	6	7	0	1	8	0	0
7	24710068	.	T	C	52	19	71	0	0	71	0	0
7	24710075	.	T	C	52	19	71	0	1	72	0	0
7	25370946	.	A	G	1	2	3	0	0	3	0	0
7	26904992	.	A	G	7	2	9	0	0	9	0	0
7	26905060	.	A	G	4	5	9	0	0	9	0	0
7	27520956	.	A	G	5	4	9	0	0	9	0	0
7	27521368	.	A	G	6	3	9	0	0	9	0	0
7	27663968	.	C	T	0	5	5	0	1	6	0	0
7	28922523	.	T	C	8	2	10	0	0	10	0	0
7	29664648	.	C	G	1	1	2	0	0	2	0	0
7	30126576	.	A	G	1	0	1	0	0	1	0	0
7	34746035	.	T	C	5	2	7	0	0	7	0	0
7	35090723	.	A	G	9	4	13	0	1	14	0	0
7	39238482	.	A	G	0	3	3	1	1	5	0	0
7	43174884	.	T	C	4	2	6	0	0	6	0	0
7	43954213	.	C	G	9	2	11	0	0	11	0	0
7	44698795	.	A	C	3	3	6	0	2	8	0	0
7	45032973	.	T	C	5	4	9	0	0	9	0	0
7	45141114	.	T	C	1	3	4	0	1	5	0	0
7	49205135	.	A	G	0	2	2	0	0	2	0	0
7	55627368	.	T	C	59	17	76	0	1	77	0	0
7	58900772	.	A	G	9	2	11	0	0	11	0	0
7	73388713	.	T	C	11	2	13	0	0	13	0	0
7	75403234	.	C	T	3	2	5	0	0	5	0	0
7	75403236	.	G	T	3	2	5	0	0	5	0	0
7	79574208	.	T	C	4	4	8	0	0	8	0	0
7	79574242	.	T	C	4	4	8	0	0	8	0	0
7	81522050	.	A	G	3	4	7	0	0	7	0	0
7	81522943	.	A	G	3	3	6	0	0	6	0	0
7	97339370	.	C	A	6	5	11	0	0	11	0	0
7	98966906	.	T	C	10	1	11	0	7	18	0	0
7	98966912	.	A	C	8	2	10	0	6	16	0	0
7	101561470	.	A	G	8	2	10	0	1	11	0	0
7	105399939	.	C	T	3	2	5	0	0	5	0	0
7	110655309	.	T	C	19	11	30	1	1	32	0	0
7	111914353	.	T	C	2	1	3	0	0	3	0	0
7	122793209	.	G	A	1	2	3	0	0	3	0	0
7	123582585	.	A	G	11	3	14	0	0	14	0	0
7	126389767	.	T	C	0	2	2	0	0	2	0	0
7	126853494	.	A	G	23	10	33	0	1	34	0	0
7	127178178	.	A	G	1	2	3	0	2	5	0	0
7	127519115	.	A	G	1	4	5	0	0	5	0	0
7	128385724	.	C	A	11	2	13	0	1	14	0	0
7	130360893	.	A	T	2	4	6	0	1	7	0	0
7	139715640	.	A	G	2	3	5	0	0	5	0	0
7	139716520	.	A	G	4	2	6	0	0	6	0	0
7	141503659	.	T	C	14	3	17	0	0	17	0	0
7	142207010	.	T	C	50	16	66	0	0	67	1	0
7	144133383	.	T	C	1	2	3	0	0	3	0	0
8	3589445	.	A	G	4	2	6	0	0	6	0	0
8	3589455	.	A	G	3	3	6	0	0	6	0	0
8	19732474	.	C	A	4	3	7	0	0	7	0	0
8	19737779	.	A	G	5	0	5	0	0	5	0	0
8	19737782	.	C	G	5	0	5	0	0	5	0	0
8	19741629	.	C	T	1	2	3	0	0	3	0	0
8	19747709	.	C	T	2	6	8	0	0	8	0	0
8	19747710	.	G	A	6	2	8	0	0	8	0	0
8	20030704	.	C	T	21	6	27	0	0	27	0	0
8	20030895	.	C	A	6	3	9	0	0	9	0	0
8	20030901	.	C	A	6	3	9	0	0	9	0	0
8	20698008	.	A	T	13	5	18	5	1	24	0	0
8	20727130	.	G	A	22	13	35	0	0	35	0	0
8	41370836	.	A	G	8	2	10	0	0	10	0	0
8	41370849	.	A	G	8	2	10	0	0	10	0	0
8	42700188	.	T	C	0	4	4	0	0	4	0	0
8	42700384	.	A	G	0	2	2	0	0	2	0	0
8	47546763	.	T	G	1	7	8	0	0	8	0	0
8	55134560	.	C	G	2	0	2	0	0	2	0	0
8	61848427	.	G	T	8	2	10	0	4	14	0	0
8	70007507	.	T	C	2	2	4	0	0	4	0	0
8	70017218	.	C	G	1	4	5	0	0	5	0	0
8	70017232	.	G	A	1	3	4	0	0	4	0	0
8	70017426	.	C	A	0	2	2	0	0	2	0	0
8	70037701	.	A	T	0	1	1	0	0	1	0	0
8	70463207	.	T	C	0	1	1	1	1	3	0	0
8	70846182	.	T	C	2	3	5	0	0	5	0	0
8	70846188	.	T	C	2	2	4	0	0	4	0	0
8	70847819	.	T	C	2	6	8	0	0	8	0	0
8	71153126	.	T	C	4	11	15	0	16	31	0	0
8	72687864	.	G	A	4	1	5	0	1	6	0	0
8	72687866	.	T	A	3	1	4	0	2	6	0	0
8	72977426	.	A	G	12	35	47	0	1	48	0	0
8	72977438	.	A	G	47	8	55	0	1	56	0	0
8	72977659	.	A	G	12	8	20	0	0	20	0	0
8	73269626	.	T	C	0	3	3	0	0	3	0	0
8	73269630	.	T	C	0	2	2	0	0	2	0	0
8	80784536	.	G	A	2	2	4	0	0	4	0	0
8	88685947	.	T	C	1	2	3	0	0	3	0	0
8	88898496	.	A	G	14	6	20	0	0	20	0	0
8	94743943	.	T	C	3	4	7	0	1	8	0	0
8	94879775	.	A	C	0	1	1	0	4	5	0	0
8	94879781	.	A	C	0	2	2	0	3	5	0	0
8	95632625	.	C	T	3	0	3	0	0	3	0	0
8	96177365	.	G	T	10	3	13	0	1	14	0	0
8	96177366	.	C	T	11	3	14	0	0	14	0	0
8	96468587	.	G	A	18	17	35	0	0	35	0	0
8	104986580	.	A	G	1	2	3	0	0	3	0	0
8	110435833	.	T	C	4	2	6	0	0	6	0	0
8	110817217	.	A	G	22	6	28	0	2	30	0	0
8	111731189	.	T	C	13	3	16	0	1	17	0	0
8	111731758	.	T	C	16	6	22	0	0	22	0	0
8	122566751	.	C	T	0	1	1	0	0	1	0	0
8	123198434	.	T	C	2	4	6	0	0	6	0	0
8	124261954	.	A	G	3	2	5	0	0	5	0	0
8	125620618	.	T	C	9	19	28	0	4	32	0	0
8	125620861	.	T	C	28	8	36	0	0	36	0	0
8	125620923	.	T	C	10	23	33	0	0	33	0	0
8	125620929	.	T	C	17	11	28	0	0	28	0	0
8	129979572	.	C	A	0	2	2	7	0	9	0	0
9	3387716	.	A	G	16	3	19	0	0	19	0	0
9	3387771	.	A	G	17	11	28	0	0	28	0	0
9	4456006	.	T	C	0	1	1	0	0	1	0	0
9	13756171	.	A	G	8	2	10	0	0	10	0	0
9	20357181	.	A	G	1	0	1	0	0	1	0	0
9	20511950	.	A	G	5	4	9	0	0	9	0	0
9	20511951	.	A	G	6	3	9	0	0	9	0	0
9	20513256	.	A	G	4	2	6	0	0	6	0	0
9	20515715	.	A	G	3	2	5	0	0	5	0	0
9	21044762	.	T	C	1	3	4	0	0	4	0	0
9	27260291	.	G	T	0	4	4	0	1	5	0	0
9	35477335	.	G	T	1	0	1	0	1	2	0	0
9	43133659	.	A	C	7	1	8	0	2	10	0	0
9	43957544	.	A	G	7	2	9	0	0	9	0	0
9	44005230	.	G	A	0	2	2	0	2	4	0	0
9	44204076	.	T	C	12	5	17	0	0	17	0	0
9	44221511	.	A	T	1	6	7	0	0	7	0	0
9	44529904	.	A	G	1	2	3	0	0	3	0	0
9	44715936	.	C	T	2	1	3	0	2	5	0	0
9	44715939	.	C	T	1	0	1	0	4	5	0	0
9	45747428	.	A	T	0	2	2	0	0	2	0	0
9	51534505	.	T	C	1	2	3	0	0	3	0	0
9	51534649	.	G	T	1	0	1	0	0	1	0	0
9	51535071	.	T	C	0	1	1	0	0	1	0	0
9	51535078	.	A	G	0	1	1	0	0	1	0	0
9	51914150	.	T	G	0	2	2	0	0	2	0	0
9	53311221	.	A	G	6	2	8	0	1	9	0	0
9	54275803	.	G	T	0	2	2	0	0	2	0	0
9	54275804	.	G	T	0	2	2	0	0	2	0	0
9	57449243	.	G	T	6	5	11	0	1	12	0	0
9	57449244	.	G	T	7	5	12	0	0	12	0	0
9	64142586	.	A	G	0	2	2	1	0	3	0	0
9	65253476	.	A	G	8	2	10	0	1	11	0	0
9	65595677	.	A	G	8	2	10	0	0	10	0	0
9	67127311	.	T	C	31	9	40	0	1	41	0	0
9	67892060	.	C	T	4	3	7	0	1	8	0	0
9	72270786	.	C	A	13	8	21	0	4	25	0	0
9	72381503	.	T	C	2	2	4	0	0	4	0	0
9	72635965	.	A	G	3	3	6	0	0	6	0	0
9	73004506	.	A	G	5	2	7	0	0	7	0	0
9	73387872	.	G	T	7	4	11	0	3	14	0	0
9	73387877	.	C	T	4	4	8	0	4	12	0	0
9	75550544	.	G	T	6	3	9	0	1	10	0	0
9	75550546	.	G	T	6	1	7	0	3	10	0	0
9	88329174	.	T	C	1	2	3	0	0	3	0	0
9	89794102	.	T	C	11	4	15	0	8	23	0	0
9	95284317	.	C	A	7	3	10	0	4	14	0	0
9	95939293	.	A	G	18	6	24	0	1	25	0	0
9	107436552	.	A	G	2	2	4	0	0	4	0	0
9	107640487	.	T	C	1	2	3	0	0	3	0	0
9	108215047	.	T	G	1	3	4	0	3	7	0	0
9	118754231	.	C	G	4	6	10	0	1	11	0	0
9	122725342	.	A	G	4	2	6	0	0	6	0	0
9	124034094	.	A	G	13	1	14	0	0	14	0	0
X	7773818	.	A	G	6	2	8	0	0	8	0	0
X	37698807	.	A	G	7	2	9	0	0	9	0	0
X	40743165	.	A	G	0	12	12	0	0	12	0	0
X	47457548	.	A	C	5	2	7	0	0	7	0	0
X	52045173	.	C	T	9	2	11	0	1	12	0	0
X	55633003	.	T	C	35	9	44	0	0	44	0	0
X	55695874	.	A	G	1	2	3	0	0	3	0	0
X	56429832	.	C	A	11	0	11	0	1	12	0	0
X	56433180	.	C	T	6	2	8	0	0	8	0	0
X	60231705	.	A	G	7	11	18	0	0	18	0	0
X	60829523	.	G	A	1	0	1	3	0	4	0	0
X	61819787	.	T	A	1	0	1	1	0	2	0	0
X	70335535	.	G	A	0	1	1	0	0	1	0	0
X	73270255	.	T	C	5	4	9	0	0	9	0	0
X	73270468	.	T	C	0	6	6	0	0	6	0	0
X	73328498	.	A	G	4	2	6	0	0	6	0	0
X	73328516	.	A	G	4	2	6	0	0	6	0	0
X	73328787	.	A	G	1	2	3	0	0	3	0	0
X	73328821	.	A	G	2	2	4	0	0	4	0	0
X	93771606	.	T	C	3	2	5	0	0	5	0	0
X	94092763	.	G	C	15	5	20	0	6	26	0	0
X	94092768	.	A	C	21	5	26	0	2	28	0	0
X	102620099	.	T	C	3	11	14	0	0	14	0	0
X	102620158	.	T	C	2	9	11	0	0	11	0	0
X	102620159	.	T	C	2	9	11	0	0	11	0	0
X	102623385	.	T	C	6	4	10	0	3	13	0	0
X	102623421	.	T	C	8	2	10	0	0	10	0	0
X	103389699	.	G	A	0	2	2	0	1	3	0	0
X	103389705	.	T	A	2	0	2	0	0	2	0	0
X	105976011	.	T	C	1	2	3	0	0	3	0	0
X	106830700	.	T	C	47	8	55	0	1	56	0	0
X	133489300	.	T	C	8	4	12	0	0	12	0	0
X	133489379	.	T	C	2	5	7	0	0	7	0	0
X	133489405	.	T	C	5	3	8	0	0	8	0	0
X	133490041	.	T	C	7	2	9	0	0	9	0	0
X	133490101	.	T	C	7	2	9	0	0	9	0	0
X	133490145	.	T	C	7	3	10	0	0	10	0	0
X	133505363	.	C	A	2	1	3	0	1	4	0	0
X	140507620	.	T	C	2	3	5	0	0	5	0	0
X	145978689	.	A	G	60	19	79	0	4	83	0	0
X	149766871	.	T	C	11	6	17	0	3	20	0	0
X	149767260	.	T	C	159	28	187	0	2	189	0	0
X	149767614	.	T	C	64	74	138	1	6	145	0	0
X	149768450	.	T	C	164	40	204	0	1	205	0	0
X	149768519	.	T	C	196	33	229	0	2	231	0	0
X	149768525	.	T	C	122	84	206	0	5	211	0	0
X	164972992	.	A	G	7	2	9	0	0	9	0	0
Y	1016394	.	A	G	11	10	21	0	0	21	0	0
Y	1048726	.	A	G	2	2	4	0	0	4	0	0
