contig	position	variantID	refAllele	altAllele	refCount	altCount	totalCount	lowMAPQDepth	lowBaseQDepth	rawDepth	otherBases	improperPairs
1	10101774	.	T	C	2	3	5	0	0	5	0	0
1	11667266	.	A	G	29	7	36	0	0	36	0	0
1	13695965	.	T	C	1	3	4	0	0	4	0	0
1	22031785	.	T	C	4	5	9	0	0	9	0	0
1	36405381	.	T	C	1	2	3	0	0	3	0	0
1	37448671	.	G	T	0	3	3	0	1	4	0	0
1	42739790	.	C	T	12	5	17	0	1	18	0	0
1	57012142	.	C	T	8	2	10	0	0	10	0	0
1	58425229	.	T	C	1	3	4	0	0	4	0	0
1	58566410	.	C	T	8	4	12	0	1	13	0	0
1	59913367	.	A	G	33	9	42	0	1	43	0	0
1	60517747	.	A	G	14	10	24	0	3	27	0	0
1	63156443	.	A	G	4	2	6	0	0	6	0	0
1	66711873	.	A	G	51	11	62	1	2	65	0	0
1	71692001	.	A	G	2	2	4	0	0	4	0	0
1	75398649	.	A	G	15	3	18	0	0	18	0	0
1	86272895	.	T	C	7	2	9	0	0	9	0	0
1	86272974	.	T	C	8	2	10	0	0	10	0	0
1	86276528	.	T	C	7	2	9	0	0	9	0	0
1	88187724	.	A	G	1	3	4	0	0	4	0	0
1	88188186	.	C	A	0	2	2	0	0	2	0	0
1	88188846	.	T	G	1	2	3	0	0	3	0	0
1	88189563	.	C	T	2	3	5	0	0	5	0	0
1	88189668	.	A	G	0	2	2	0	0	2	0	0
1	88189685	.	C	A	0	2	2	0	0	2	0	0
1	88190717	.	G	C	2	2	4	0	0	4	0	0
1	88191237	.	A	C	5	30	35	0	2	37	0	0
1	88191320	.	C	T	6	26	32	0	0	32	0	0
1	88191710	.	T	C	10	20	30	0	0	30	0	0
1	88192048	.	G	C	7	29	36	0	1	37	0	0
1	88192098	.	G	A	26	11	37	0	0	37	0	0
1	88192180	.	G	T	33	9	42	0	1	43	0	0
1	88192184	.	T	A	30	9	39	0	4	43	0	0
1	88192243	.	A	G	6	24	30	0	2	32	0	0
1	88192700	.	G	A	8	25	33	0	2	35	0	0
1	88192756	.	G	A	5	24	29	0	1	30	0	0
1	88192844	.	G	A	4	26	30	0	0	30	0	0
1	88192980	.	A	G	4	33	37	1	1	39	0	0
1	88193031	.	C	G	7	10	17	1	0	18	0	0
1	88193194	.	C	T	5	4	9	0	0	9	0	0
1	88193568	.	A	C	1	4	5	0	0	5	0	0
1	88193917	.	G	A	4	13	17	0	0	17	0	0
1	88197053	.	T	C	0	2	2	0	0	2	0	0
1	88197991	.	A	G	4	14	18	0	0	18	0	0
1	88200452	.	A	G	3	22	25	0	0	25	0	0
1	88200605	.	C	A	0	3	3	0	0	3	0	0
1	88200653	.	A	C	2	8	10	0	0	10	0	0
1	88200670	.	G	A	2	11	13	0	0	13	0	0
1	88200718	.	C	A	1	9	10	0	0	10	0	0
1	88200832	.	C	T	1	9	10	0	0	10	0	0
1	88202772	.	A	T	3	0	3	0	0	3	0	0
1	88204960	.	T	C	0	2	2	2	1	5	0	0
1	88205197	.	A	G	0	1	1	0	0	1	0	0
1	88205247	.	A	G	1	0	1	1	0	2	0	0
1	91456726	.	T	C	6	3	9	0	1	10	0	0
1	91860479	.	C	T	2	2	4	0	0	4	0	0
1	91860480	.	G	T	1	2	3	0	1	4	0	0
1	93299307	.	A	G	9	2	11	0	1	12	0	0
1	95517057	.	A	C	10	2	12	0	1	13	0	0
1	97877103	.	C	T	0	2	2	0	0	2	0	0
1	118228369	.	G	T	14	4	18	0	5	23	0	0
1	131953439	.	T	C	14	10	24	0	0	24	0	0
1	143631116	.	T	C	3	14	17	0	0	17	0	0
1	156255182	.	T	C	6	7	13	0	0	13	0	0
1	156255601	.	T	C	5	3	8	0	0	8	0	0
1	160839934	.	T	C	7	2	9	0	0	9	0	0
1	166826863	.	C	T	7	2	9	0	0	9	0	0
1	166916330	.	A	C	6	3	9	0	6	15	0	0
1	166916336	.	A	C	8	7	15	0	1	16	0	0
1	179992462	.	A	C	10	3	13	0	3	16	0	0
1	180924020	.	T	C	17	5	22	0	0	22	0	0
1	181731983	.	A	G	17	5	22	0	1	23	0	0
1	183190594	.	A	G	12	4	16	0	0	16	0	0
1	183190682	.	A	G	6	2	8	0	1	9	0	0
10	5752204	.	A	G	2	5	7	0	0	7	0	0
10	8598013	.	A	G	7	3	10	0	0	10	0	0
10	11333810	.	C	T	9	4	13	0	1	14	0	0
10	11333814	.	C	T	11	3	14	0	1	15	0	0
10	14621525	.	C	T	3	0	3	0	1	4	0	0
10	29104018	.	G	T	6	3	9	0	2	11	0	0
10	29104019	.	G	T	6	4	10	0	1	11	0	0
10	33865251	.	T	C	1	3	4	0	0	4	0	0
10	33868473	.	T	C	4	2	6	0	1	7	0	0
10	33868474	.	T	C	3	3	6	0	1	7	0	0
10	34169589	.	T	C	0	2	2	0	0	2	0	0
10	45752162	.	G	A	3	3	6	0	0	6	0	0
10	49118546	.	T	C	7	2	9	0	0	9	0	0
10	49118584	.	T	C	5	14	19	0	0	19	0	0
10	49118640	.	T	C	8	4	12	0	0	13	1	0
10	49120426	.	T	C	0	4	4	0	0	4	0	0
10	49148872	.	T	C	0	16	16	0	1	17	0	0
10	49148885	.	T	C	0	16	16	0	0	16	0	0
10	60019028	.	A	G	2	2	4	0	0	4	0	0
10	67373837	.	C	T	8	2	10	0	1	11	0	0
10	70027024	.	G	T	9	3	12	0	1	13	0	0
10	81366434	.	G	T	0	3	3	0	1	4	0	0
10	82062115	.	T	C	8	4	12	0	1	13	0	0
10	82486401	.	T	C	10	3	13	0	1	14	0	0
10	82486613	.	T	C	15	5	20	0	0	20	0	0
10	86672203	.	A	G	9	4	13	0	0	13	0	0
10	86672208	.	A	G	9	5	14	0	2	16	0	0
10	88306334	.	T	C	9	3	12	0	0	12	0	0
10	89654262	.	C	A	4	6	10	0	0	10	0	0
10	90952481	.	A	G	4	2	6	0	0	6	0	0
10	94057224	.	A	G	11	6	17	0	0	17	0	0
10	94057234	.	A	G	8	3	11	0	0	11	0	0
10	95247895	.	C	T	1	2	3	0	0	3	0	0
10	95247896	.	C	T	1	1	2	0	1	3	0	0
10	111137261	.	G	T	4	2	6	0	0	6	0	0
10	127216552	.	T	C	2	1	3	0	5	8	0	0
11	3077575	.	C	A	4	1	5	6	1	12	0	0
11	3079021	.	A	T	6	2	8	0	1	9	0	0
11	3902194	.	A	C	0	3	3	0	0	3	0	0
11	4092032	.	T	C	15	3	18	0	2	20	0	0
11	4092085	.	T	C	11	15	26	0	1	27	0	0
11	4092790	.	T	C	16	9	25	0	0	25	0	0
11	29495263	.	T	A	1	4	5	0	2	7	0	0
11	31615184	.	A	T	2	2	4	0	0	4	0	0
11	32374595	.	C	T	4	1	5	0	0	5	0	0
11	43572939	.	A	G	6	3	9	0	0	9	0	0
11	43573028	.	A	G	5	3	8	0	0	8	0	0
11	45821425	.	T	C	9	5	14	0	0	14	0	0
11	46163470	.	T	C	21	135	156	0	3	159	0	0
11	48716315	.	T	C	0	2	2	0	0	2	0	0
11	51472175	.	T	C	6	2	8	0	0	8	0	0
11	59347027	.	A	G	13	7	20	0	0	20	0	0
11	59347029	.	A	G	14	6	20	0	0	20	0	0
11	59347072	.	A	G	14	6	20	0	2	22	0	0
11	59349201	.	A	G	13	5	18	0	1	19	0	0
11	59401881	.	A	G	2	4	6	0	0	6	0	0
11	68885137	.	C	T	3	0	3	0	0	3	0	0
11	69922901	.	A	G	3	4	7	0	1	8	0	0
11	69922950	.	A	G	3	2	5	0	0	5	0	0
11	69923921	.	A	G	8	4	12	0	0	12	0	0
11	69924751	.	A	G	4	2	6	0	0	6	0	0
11	69925810	.	A	G	4	2	6	0	1	7	0	0
11	69925824	.	A	G	3	3	6	0	0	6	0	0
11	69925878	.	A	G	8	2	10	0	2	12	0	0
11	69926003	.	A	G	3	3	6	0	0	6	0	0
11	69926812	.	A	G	4	4	8	0	0	8	0	0
11	69926813	.	A	G	3	5	8	0	0	8	0	0
11	69927946	.	A	G	5	6	11	0	0	11	0	0
11	69928014	.	A	G	3	3	6	0	0	6	0	0
11	70500705	.	C	T	8	2	10	0	0	10	0	0
11	70500706	.	G	A	8	2	10	0	0	10	0	0
11	75067210	.	T	C	22	4	26	0	1	27	0	0
11	75067258	.	T	C	15	5	20	0	0	20	0	0
11	77426880	.	T	C	28	7	35	0	0	35	0	0
11	77873990	.	T	G	9	3	12	0	1	13	0	0
11	78187443	.	A	G	3	2	5	0	0	5	0	0
11	78736472	.	A	G	0	3	3	0	0	3	0	0
11	79391831	.	G	T	1	2	3	0	0	3	0	0
11	84426000	.	A	G	1	0	1	0	0	1	0	0
11	86391637	.	G	T	5	4	9	0	2	11	0	0
11	86521333	.	T	C	0	5	5	0	0	5	0	0
11	86521497	.	G	A	1	2	3	4	0	7	0	0
11	86521633	.	T	C	0	1	1	2	0	3	0	0
11	88927208	.	T	C	9	7	16	0	0	16	0	0
11	94431842	.	T	C	7	3	10	0	0	10	0	0
11	95659143	.	C	T	8	4	12	0	0	12	0	0
11	95962333	.	T	C	8	4	12	0	0	12	0	0
11	97285031	.	A	C	4	2	6	0	0	6	0	0
11	98217070	.	A	G	17	6	23	0	3	26	0	0
11	100488792	.	T	C	11	3	14	0	0	14	0	0
11	101089107	.	T	C	8	3	11	0	0	11	0	0
11	101089126	.	T	C	6	3	9	0	0	9	0	0
11	101089507	.	T	C	7	2	9	0	0	9	0	0
11	101089557	.	T	C	10	4	14	0	1	15	0	0
11	101089729	.	T	C	7	6	13	0	0	13	0	0
11	101089734	.	T	C	6	7	13	0	0	13	0	0
11	101089802	.	T	C	6	7	13	0	0	13	0	0
11	105820127	.	G	A	1	2	3	0	0	3	0	0
11	108840806	.	C	T	4	4	8	0	0	8	0	0
11	109467746	.	T	G	3	2	5	0	1	6	0	0
11	116471963	.	T	C	1	11	12	0	1	13	0	0
11	116810095	.	A	G	11	2	13	0	0	13	0	0
11	119037626	.	T	C	13	3	16	0	1	17	0	0
12	3454168	.	A	G	35	10	45	0	0	45	0	0
12	3454248	.	A	G	21	23	44	0	3	47	0	0
12	8547666	.	A	T	0	3	3	0	0	3	0	0
12	11289991	.	T	C	2	2	4	0	0	4	0	0
12	17479809	.	A	G	9	10	19	0	0	19	0	0
12	25009853	.	C	A	4	3	7	0	2	9	0	0
12	38917612	.	A	C	10	7	17	0	1	18	0	0
12	38917619	.	A	C	9	3	12	0	1	13	0	0
12	46747117	.	T	C	33	10	43	0	0	43	0	0
12	54718540	.	T	C	12	5	17	0	0	17	0	0
12	54719070	.	T	C	13	3	16	0	0	16	0	0
12	55659052	.	A	G	4	2	6	0	0	6	0	0
12	69244102	.	A	G	7	3	10	0	0	10	0	0
12	70311671	.	T	A	10	1	11	0	2	13	0	0
12	71041403	.	A	G	2	20	22	0	0	22	0	0
12	71041410	.	A	G	18	3	21	0	0	21	0	0
12	71041903	.	A	G	5	18	23	0	1	24	0	0
12	71041909	.	A	G	18	5	23	0	1	24	0	0
12	72953219	.	T	C	6	2	8	0	0	8	0	0
12	75679509	.	C	A	4	1	5	0	2	7	0	0
12	78887986	.	T	C	6	2	8	0	0	8	0	0
12	81245339	.	G	A	13	12	25	0	0	25	0	0
12	81419225	.	C	T	1	2	3	0	0	3	0	0
12	86726722	.	A	C	4	4	8	0	3	11	0	0
12	86726725	.	T	C	4	3	7	0	1	8	0	0
12	91556413	.	G	A	0	3	3	0	0	3	0	0
12	91605436	.	T	C	4	3	7	0	0	7	0	0
12	101886131	.	T	C	14	5	19	0	2	21	0	0
12	101887890	.	T	C	14	3	17	0	0	17	0	0
12	103150102	.	G	A	4	3	7	0	5	12	0	0
12	108756817	.	T	C	4	2	6	0	0	6	0	0
12	108993691	.	A	G	3	2	5	0	0	5	0	0
12	109428496	.	G	T	7	1	8	0	2	10	0	0
12	109428497	.	A	T	8	1	9	0	1	10	0	0
12	112879959	.	G	A	0	2	2	0	0	2	0	0
12	113117444	.	C	T	0	3	3	0	0	3	0	0
13	3702310	.	A	G	11	2	13	0	0	13	0	0
13	3702325	.	A	G	6	4	10	0	0	10	0	0
13	3702360	.	A	G	1	4	5	0	0	5	0	0
13	3703271	.	T	A	3	6	9	0	0	10	1	0
13	8901801	.	T	C	15	4	19	0	0	19	0	0
13	14000142	.	C	T	17	4	21	0	1	22	0	0
13	17978887	.	T	C	2	3	5	0	0	5	0	0
13	17978929	.	T	C	1	4	5	0	0	5	0	0
13	17978950	.	T	C	2	2	4	0	0	4	0	0
13	21574103	.	T	C	3	2	5	0	0	5	0	0
13	21574169	.	T	C	4	5	9	0	0	9	0	0
13	21576512	.	T	C	8	2	10	0	0	10	0	0
13	21576591	.	T	C	1	1	2	0	0	2	0	0
13	21576615	.	T	C	4	3	7	0	0	7	0	0
13	21685475	.	A	G	0	2	2	3	0	5	0	0
13	45709825	.	G	A	0	2	2	0	1	3	0	0
13	45709828	.	C	A	0	3	3	0	0	3	0	0
13	49685611	.	A	G	1	2	3	0	0	3	0	0
13	49685633	.	A	G	1	3	4	0	0	4	0	0
13	56886876	.	G	T	9	1	10	0	1	11	0	0
13	63448526	.	A	G	5	3	8	0	0	8	0	0
13	63690911	.	C	T	2	2	4	0	0	4	0	0
13	64438124	.	T	C	13	4	17	0	0	17	0	0
13	67621455	.	T	C	2	3	5	0	0	5	0	0
13	67967765	.	T	C	0	2	2	0	0	2	0	0
13	69759382	.	G	A	8	2	10	0	0	10	0	0
13	75793212	.	C	T	0	4	4	5	0	9	0	0
13	100648134	.	C	G	0	2	2	0	0	2	0	0
13	100839326	.	T	C	3	5	8	0	0	8	0	0
13	100839340	.	T	C	4	3	7	0	1	8	0	0
13	100839361	.	T	C	10	4	14	0	0	14	0	0
13	107861323	.	C	T	5	4	9	0	4	13	0	0
13	119625401	.	G	T	12	9	21	0	0	21	0	0
14	9647289	.	A	G	37	6	43	0	0	43	0	0
14	10058181	.	A	G	22	10	32	0	0	32	0	0
14	14533725	.	T	C	0	1	1	0	0	1	0	0
14	20517408	.	T	C	1	2	3	0	0	3	0	0
14	21846832	.	A	G	7	25	32	0	1	33	0	0
14	21846833	.	A	G	26	5	31	0	2	33	0	0
14	21847779	.	A	G	46	15	61	0	2	63	0	0
14	21847872	.	A	G	37	9	46	0	1	47	0	0
14	24184033	.	A	G	2	2	4	0	0	4	0	0
14	26382413	.	T	C	2	2	4	0	0	4	0	0
14	29788070	.	T	C	9	1	10	0	1	11	0	0
14	29788078	.	T	C	5	3	8	0	0	8	0	0
14	30876643	.	C	A	2	0	2	0	0	2	0	0
14	31389998	.	G	A	5	2	7	0	0	7	0	0
14	31422583	.	T	C	28	8	36	0	0	36	0	0
14	31422619	.	T	C	21	15	36	0	1	37	0	0
14	31422620	.	T	C	31	5	36	0	1	37	0	0
14	32018582	.	A	G	29	8	37	0	1	38	0	0
14	45372232	.	T	C	10	2	12	0	0	12	0	0
14	47558234	.	A	G	3	2	5	0	0	5	0	0
14	51014498	.	T	C	4	2	6	0	0	6	0	0
14	51109987	.	A	G	1	3	4	0	0	4	0	0
14	51115790	.	A	G	5	2	7	0	0	7	0	0
14	51115791	.	A	G	5	2	7	0	0	7	0	0
14	52531686	.	A	G	10	39	49	0	1	50	0	0
14	58064703	.	G	T	0	2	2	0	0	2	0	0
14	60449377	.	T	C	2	2	4	0	0	4	0	0
14	60478990	.	T	C	2	2	4	0	0	4	0	0
14	60618107	.	C	A	2	3	5	0	1	6	0	0
14	63194559	.	G	T	6	3	9	0	0	9	0	0
14	70445410	.	T	C	2	2	4	0	0	4	0	0
14	75957159	.	T	C	14	3	17	0	0	17	0	0
14	79703414	.	T	C	1	2	3	0	0	3	0	0
14	98026260	.	A	G	2	2	4	0	0	4	0	0
14	103584115	.	T	C	13	6	19	0	0	19	0	0
14	105832155	.	A	G	1	2	3	0	0	3	0	0
14	119113824	.	G	A	5	2	7	0	1	8	0	0
15	8167411	.	A	T	5	0	5	0	0	6	1	0
15	8187674	.	A	G	5	7	12	0	0	12	0	0
15	8188973	.	A	G	7	3	10	0	0	10	0	0
15	25004406	.	T	A	2	2	4	0	1	5	0	0
15	38956891	.	T	C	10	3	13	0	0	13	0	0
15	54733598	.	C	T	3	2	5	0	0	5	0	0
15	55118692	.	A	G	6	6	12	0	1	13	0	0
15	55118708	.	A	G	8	4	12	0	0	12	0	0
15	55118751	.	A	G	11	2	13	0	1	14	0	0
15	76601451	.	A	G	4	2	6	0	0	6	0	0
15	78900113	.	T	C	2	5	7	0	0	7	0	0
15	78900170	.	T	C	2	2	4	0	0	4	0	0
15	79133222	.	G	A	21	15	36	0	0	36	0	0
15	80816550	.	A	G	5	5	10	0	0	10	0	0
15	81338179	.	A	G	7	2	9	0	1	10	0	0
15	81339166	.	A	G	7	4	11	0	0	11	0	0
15	81733114	.	C	T	2	4	6	0	1	7	0	0
15	81791419	.	A	G	3	2	5	0	0	5	0	0
15	81799307	.	G	A	17	8	25	0	5	30	0	0
15	95117440	.	A	G	30	17	47	0	37	84	0	0
15	98634993	.	T	C	13	21	34	0	2	36	0	0
15	98731431	.	T	C	25	6	31	0	0	31	0	0
15	98932367	.	T	C	1	0	1	1	0	2	0	0
15	99142536	.	T	C	0	2	2	0	0	2	0	0
15	99626091	.	A	G	8	4	12	0	0	12	0	0
15	99627261	.	A	G	3	7	10	0	0	10	0	0
15	99627262	.	A	G	6	4	10	0	0	10	0	0
16	3680985	.	T	C	5	9	14	0	0	14	0	0
16	4444280	.	T	C	4	2	6	0	0	6	0	0
16	10952249	.	C	T	6	2	8	0	0	8	0	0
16	13520445	.	A	G	17	12	29	0	0	29	0	0
16	13520501	.	A	G	9	2	11	0	1	12	0	0
16	13650548	.	T	C	1	2	3	0	0	3	0	0
16	13651947	.	T	C	16	5	21	0	0	21	0	0
16	16969888	.	A	G	4	4	8	0	0	8	0	0
16	17335960	.	A	G	6	2	8	0	0	8	0	0
16	18102440	.	T	C	13	2	15	0	0	15	0	0
16	19942498	.	A	G	30	15	45	0	1	46	0	0
16	19943076	.	A	G	39	6	45	0	1	46	0	0
16	20026406	.	A	G	7	1	8	0	0	8	0	0
16	20512079	.	T	C	7	6	13	0	20	33	0	0
16	22660689	.	A	T	5	0	5	0	0	5	0	0
16	30330773	.	T	C	6	3	9	0	0	9	0	0
16	32118742	.	A	G	6	2	8	0	0	8	0	0
16	32119086	.	A	G	9	5	14	0	0	14	0	0
16	32119106	.	A	G	11	7	18	0	0	18	0	0
16	32119150	.	A	G	13	8	21	0	0	21	0	0
16	32209076	.	C	T	3	2	5	0	0	5	0	0
16	33320726	.	T	A	3	2	5	0	2	7	0	0
16	35834520	.	A	G	1	4	5	0	0	5	0	0
16	37656108	.	G	A	3	3	6	0	1	7	0	0
16	38319163	.	G	A	1	2	3	0	0	3	0	0
16	38319167	.	G	A	1	2	3	0	0	3	0	0
16	75398743	.	A	G	0	2	2	0	0	2	0	0
16	78133495	.	A	G	3	2	5	0	0	5	0	0
16	87230813	.	T	C	12	7	19	0	0	19	0	0
16	87230814	.	T	C	13	6	19	0	0	19	0	0
16	87737431	.	T	C	0	1	1	0	0	1	0	0
16	89584427	.	A	G	0	14	14	0	3	17	0	0
16	89584429	.	A	G	9	0	9	0	9	18	0	0
16	90294472	.	A	G	6	2	8	0	1	9	0	0
16	91452977	.	A	G	43	29	72	0	3	75	0	0
16	91453021	.	A	G	48	9	57	0	1	58	0	0
16	91715165	.	A	G	17	5	22	0	1	23	0	0
16	95957876	.	G	T	13	3	16	0	0	16	0	0
16	97832881	.	G	A	4	2	6	0	0	6	0	0
17	6288889	.	G	T	11	3	14	0	2	16	0	0
17	6330894	.	T	C	2	0	2	0	0	2	0	0
17	10429111	.	C	T	3	2	5	0	0	5	0	0
17	15741073	.	A	G	5	3	8	0	0	8	0	0
17	15741577	.	A	G	2	5	7	0	0	7	0	0
17	15741583	.	A	G	3	4	7	0	0	7	0	0
17	17565852	.	C	T	0	0	0	4	0	4	0	0
17	24395428	.	T	C	21	7	28	0	0	28	0	0
17	24395462	.	T	C	21	7	28	0	0	28	0	0
17	24395463	.	T	C	20	8	28	0	0	28	0	0
17	24397285	.	T	C	16	12	28	0	0	28	0	0
17	24397327	.	T	C	3	8	11	0	2	13	0	0
17	24941918	.	T	C	4	2	6	0	0	6	0	0
17	25163139	.	A	G	4	2	6	0	0	6	0	0
17	29919416	.	A	G	1	2	3	0	0	3	0	0
17	31333483	.	C	T	2	13	15	0	4	19	0	0
17	33037766	.	T	C	10	2	12	0	1	13	0	0
17	33328500	.	G	C	0	2	2	0	4	6	0	0
17	33550719	.	T	C	7	3	10	0	0	10	0	0
17	33550725	.	T	C	9	2	11	0	1	12	0	0
17	33552004	.	T	C	4	2	6	0	1	7	0	0
17	33906273	.	T	C	3	2	5	0	0	5	0	0
17	34835658	.	T	A	1	1	2	0	1	3	0	0
17	34864962	.	A	C	3	2	5	0	2	7	0	0
17	34864966	.	G	C	2	0	2	0	3	5	0	0
17	36168626	.	A	G	3	2	5	0	1	6	0	0
17	40158498	.	T	C	2945	4195	7140	0	154	7644	350	0
17	45973875	.	T	C	9	17	26	0	5	31	0	0
17	46765491	.	G	A	7	3	10	0	3	13	0	0
17	46765496	.	G	A	6	8	14	0	1	15	0	0
17	47085857	.	T	C	12	7	19	0	0	19	0	0
17	56549405	.	C	T	6	2	8	0	0	8	0	0
17	63806215	.	T	C	9	3	12	0	0	12	0	0
17	95064364	.	T	C	11	3	14	0	0	14	0	0
17	95067396	.	T	C	10	8	18	0	0	18	0	0
17	95067479	.	T	C	15	10	25	0	1	26	0	0
17	95123375	.	T	C	2	1	3	0	1	4	0	0
17	95140807	.	T	C	3	1	4	0	0	4	0	0
17	95140813	.	T	C	2	1	3	0	0	3	0	0
18	5565859	.	C	T	3	3	6	0	0	6	0	0
18	6792650	.	A	G	15	6	21	0	0	21	0	0
18	6792857	.	A	G	12	8	20	0	0	20	0	0
18	6793851	.	A	G	15	4	19	0	2	21	0	0
18	15334776	.	T	C	1	2	3	0	0	3	0	0
18	15334781	.	C	T	1	2	3	0	0	3	0	0
18	24097917	.	A	G	4	2	6	0	0	6	0	0
18	24098007	.	A	G	3	2	5	0	0	5	0	0
18	25155686	.	A	G	2	0	2	0	0	2	0	0
18	32235557	.	A	G	2	1	3	0	2	5	0	0
18	32235608	.	A	G	5	4	9	0	0	9	0	0
18	32235643	.	A	G	3	4	7	0	0	7	0	0
18	32235652	.	A	G	4	4	8	0	0	8	0	0
18	32235930	.	A	G	2	9	11	0	0	11	0	0
18	32999202	.	C	T	3	2	5	0	2	7	0	0
18	35806172	.	G	A	8	10	18	0	2	20	0	0
18	35807586	.	T	C	37	9	46	0	0	46	0	0
18	53995625	.	G	A	1	1	2	0	0	2	0	0
18	57089998	.	T	C	11	5	16	0	0	16	0	0
18	57090012	.	T	C	2	14	16	0	0	16	0	0
18	62794785	.	A	G	2	3	5	0	0	5	0	0
18	65610148	.	A	G	4	3	7	0	0	7	0	0
18	65610162	.	A	G	5	4	9	0	0	9	0	0
19	4813159	.	T	C	3	2	5	0	0	5	0	0
19	7176321	.	G	A	6	37	43	2	21	66	0	0
19	7402857	.	A	C	10	3	13	0	2	15	0	0
19	7402866	.	A	C	7	1	8	0	3	11	0	0
19	7515480	.	A	G	15	4	19	0	0	19	0	0
19	7516422	.	A	C	1	3	4	0	1	5	0	0
19	8900145	.	A	G	3	3	6	0	0	6	0	0
19	8900203	.	A	G	3	2	5	0	0	5	0	0
19	10223052	.	T	C	51	10	61	0	1	62	0	0
19	10223060	.	T	C	17	43	60	0	1	61	0	0
19	12441626	.	A	G	15	8	23	0	0	23	0	0
19	29248791	.	T	G	7	4	11	0	0	11	0	0
19	40729466	.	A	G	6	2	8	0	0	8	0	0
19	41818939	.	A	G	6	2	8	0	0	8	0	0
19	43429601	.	A	G	8	4	12	0	1	13	0	0
19	43429686	.	A	G	10	3	13	0	0	13	0	0
19	43429753	.	A	G	16	4	20	0	0	20	0	0
19	43836369	.	G	A	10	2	12	0	0	12	0	0
19	44993669	.	T	C	31	5	36	0	2	38	0	0
19	46269419	.	A	G	1	3	4	0	0	4	0	0
19	61212681	.	A	G	7	2	9	0	0	9	0	0
2	13016235	.	C	T	14	3	17	0	3	20	0	0
2	13016239	.	C	T	13	1	14	0	4	18	0	0
2	14153560	.	A	G	1	2	3	0	1	4	0	0
2	18219466	.	T	C	2	2	4	0	0	4	0	0
2	18219472	.	T	C	1	2	3	0	0	3	0	0
2	18220185	.	T	C	5	2	7	0	1	8	0	0
2	26800818	.	C	T	4	2	6	0	0	6	0	0
2	30920955	.	T	C	11	6	17	0	0	17	0	0
2	30921679	.	G	A	5	3	8	0	1	9	0	0
2	31505906	.	A	G	6	2	8	0	0	8	0	0
2	31937444	.	A	G	6	2	8	0	0	8	0	0
2	38901995	.	A	G	8	2	10	0	0	10	0	0
2	50082793	.	G	A	8	2	10	0	3	13	0	0
2	50082797	.	G	A	9	3	12	0	2	14	0	0
2	55005781	.	C	T	3	2	5	0	1	6	0	0
2	55005783	.	G	T	3	1	4	0	2	6	0	0
2	56997529	.	G	T	8	1	9	0	2	11	0	0
2	56997530	.	C	T	8	1	9	0	2	11	0	0
2	67952998	.	A	T	1	10	11	0	1	12	0	0
2	69709330	.	T	C	0	1	1	0	0	1	0	0
2	69709339	.	T	C	0	1	1	0	0	1	0	0
2	80461965	.	A	T	8	3	11	0	0	11	0	0
2	84480963	.	C	T	13	3	16	0	0	16	0	0
2	90985278	.	C	T	6	0	6	0	0	6	0	0
2	91043632	.	A	G	28	9	37	0	1	38	0	0
2	91551819	.	A	G	3	2	5	0	0	5	0	0
2	102612558	.	T	A	7	36	43	0	4	47	0	0
2	104121981	.	C	T	1	0	1	0	0	1	0	0
2	104511117	.	T	C	19	11	30	0	0	30	0	0
2	104511123	.	T	C	19	5	24	0	3	27	0	0
2	104511430	.	T	C	9	2	11	0	0	11	0	0
2	112185846	.	A	G	2	5	7	0	0	7	0	0
2	112185852	.	A	G	3	5	8	0	0	8	0	0
2	115895896	.	T	C	8	1	9	0	5	14	0	0
2	118577740	.	C	T	13	8	21	0	3	24	0	0
2	118700340	.	A	G	8	4	12	0	0	12	0	0
2	118700734	.	A	G	3	1	4	0	2	6	0	0
2	120564258	.	T	C	19	21	40	0	0	40	0	0
2	120564286	.	T	C	34	7	41	0	1	42	0	0
2	120564302	.	T	C	26	15	41	0	0	41	0	0
2	126733408	.	T	C	12	2	14	0	0	14	0	0
2	126734836	.	T	C	7	7	14	0	2	16	0	0
2	130396840	.	A	G	1	3	4	0	0	4	0	0
2	130396876	.	A	G	5	5	10	0	0	10	0	0
2	130397803	.	A	G	9	3	12	0	0	12	0	0
2	130397973	.	A	G	1	6	7	0	0	7	0	0
2	130397974	.	A	G	3	4	7	0	0	7	0	0
2	130410093	.	A	G	2	3	5	0	1	6	0	0
2	130715901	.	T	C	1	3	4	0	0	4	0	0
2	132151800	.	A	G	46	217	263	1	2	266	0	0
2	144382358	.	A	G	8	5	13	0	1	14	0	0
2	152114942	.	A	G	3	6	9	0	0	9	0	0
2	152115260	.	A	G	4	2	6	0	0	6	0	0
2	153459226	.	T	C	1	3	4	0	1	5	0	0
2	153460309	.	T	C	2	3	5	0	0	5	0	0
2	154379850	.	A	G	16	6	22	0	1	23	0	0
2	156563781	.	A	C	13	5	18	0	5	23	0	0
2	157313041	.	A	C	8	3	11	0	5	16	0	0
2	157400060	.	T	C	43	22	65	0	1	66	0	0
2	157400069	.	T	C	35	28	63	0	1	64	0	0
2	158220838	.	A	G	5	4	9	0	2	11	0	0
2	158226873	.	A	G	58	283	341	0	20	361	0	0
2	163309459	.	T	C	8	7	15	0	1	16	0	0
2	164953669	.	T	C	36	11	47	0	0	47	0	0
2	164953773	.	T	C	22	9	31	0	1	32	0	0
2	168055438	.	T	C	6	2	8	0	1	9	0	0
2	169913325	.	A	G	2	2	4	0	0	4	0	0
2	169913421	.	A	G	4	3	7	0	0	7	0	0
2	174169694	.	A	G	49	12	61	1	1	63	0	0
2	179745031	.	A	G	8	2	10	0	0	10	0	0
2	180727466	.	T	C	10	2	12	0	0	12	0	0
2	181196887	.	A	G	28	5	33	0	0	33	0	0
2	181510490	.	A	G	35	8	43	0	1	44	0	0
3	19278361	.	T	C	4	2	6	0	0	6	0	0
3	32393742	.	T	G	7	4	11	2	5	18	0	0
3	32519249	.	G	A	5	8	13	0	3	16	0	0
3	39050209	.	A	G	6	1	7	0	0	7	0	0
3	40656522	.	T	C	2	2	4	0	0	4	0	0
3	40747624	.	A	G	19	8	27	0	0	27	0	0
3	40747629	.	A	G	17	13	30	0	0	30	0	0
3	40748383	.	G	A	6	3	9	0	1	10	0	0
3	40748697	.	A	G	33	5	38	0	0	38	0	0
3	54701778	.	C	T	5	1	6	0	0	6	0	0
3	54706896	.	A	G	11	3	14	0	0	14	0	0
3	57551908	.	T	C	1	2	3	0	0	3	0	0
3	57553246	.	T	C	3	1	4	0	1	5	0	0
3	65461294	.	C	A	7	2	9	0	1	10	0	0
3	65587492	.	A	G	1	2	3	0	0	3	0	0
3	65868019	.	A	G	7	2	9	0	0	9	0	0
3	68898424	.	T	C	1	2	3	0	0	3	0	0
3	80599593	.	T	C	9	38	47	0	0	47	0	0
3	80613850	.	T	C	6	3	9	0	0	9	0	0
3	80613956	.	T	C	6	10	16	0	0	16	0	0
3	80613957	.	T	C	11	5	16	0	0	16	0	0
3	80614159	.	T	C	4	6	10	0	0	10	0	0
3	80614215	.	T	C	81	28	109	0	4	113	0	0
3	81866059	.	A	G	1	2	3	0	0	3	0	0
3	88259488	.	A	G	1	2	3	0	0	3	0	0
3	88259498	.	A	G	0	2	2	0	0	2	0	0
3	88259542	.	A	G	12	2	14	0	0	14	0	0
3	88259584	.	A	G	5	3	8	0	0	8	0	0
3	90268884	.	G	A	7	6	13	0	2	15	0	0
3	94686717	.	C	T	3	1	4	0	0	4	0	0
3	94794244	.	T	A	3	2	5	0	0	5	0	0
3	94794245	.	G	A	3	2	5	0	0	5	0	0
3	95037897	.	T	C	6	2	8	0	0	8	0	0
3	95037904	.	T	C	6	2	8	0	0	8	0	0
3	96539776	.	A	G	5	11	16	0	1	17	0	0
3	96539979	.	A	G	10	3	13	0	2	15	0	0
3	101483698	.	G	C	7	7	14	0	11	26	1	0
3	101483703	.	G	C	16	5	21	0	13	34	0	0
3	102973406	.	A	G	32	17	49	0	2	51	0	0
3	103187243	.	A	G	6	2	8	0	0	8	0	0
3	104835351	.	A	G	4	4	8	0	0	8	0	0
3	104835352	.	A	G	5	2	7	0	1	8	0	0
3	104835398	.	A	G	9	2	11	0	0	11	0	0
3	108109603	.	A	G	2	0	2	0	1	3	0	0
3	110050717	.	C	T	5	3	8	0	1	9	0	0
3	116537733	.	T	C	13	5	18	0	0	18	0	0
3	116537746	.	T	C	12	4	16	0	2	18	0	0
3	116537812	.	T	C	4	2	6	0	0	6	0	0
3	116538330	.	T	C	11	9	20	1	0	21	0	0
3	116538353	.	T	C	6	4	10	0	0	10	0	0
3	129707407	.	C	T	5	2	7	0	0	7	0	0
3	135112631	.	T	C	45	10	55	0	1	56	0	0
3	143894308	.	C	T	7	2	9	0	1	10	0	0
3	144394605	.	G	T	8	3	11	0	1	12	0	0
3	144394606	.	A	T	9	1	10	0	2	12	0	0
3	146435333	.	A	T	2	2	4	0	0	4	0	0
3	151935613	.	A	G	1	2	3	0	0	3	0	0
3	158666700	.	G	T	0	1	1	0	0	1	0	0
4	4763464	.	C	T	24	16	40	0	8	48	0	0
4	6219479	.	G	A	8	3	11	0	2	13	0	0
4	6219480	.	C	A	9	2	11	0	2	13	0	0
4	9576791	.	G	A	7	6	13	0	0	13	0	0
4	11254104	.	C	G	6	1	7	0	0	7	0	0
4	11549972	.	G	T	2	2	4	0	0	4	0	0
4	11549974	.	A	T	1	2	3	0	1	4	0	0
4	21834548	.	A	G	12	9	21	0	0	21	0	0
4	21834757	.	A	G	8	2	10	0	0	10	0	0
4	21834791	.	A	G	4	6	10	0	0	10	0	0
4	21836592	.	A	G	24	4	28	0	3	31	0	0
4	21911667	.	A	G	3	2	5	0	0	5	0	0
4	21911680	.	A	G	8	2	10	0	0	10	0	0
4	21911886	.	A	G	11	5	16	0	0	16	0	0
4	28967378	.	G	A	4	0	4	0	4	8	0	0
4	28967380	.	C	A	4	2	6	0	2	8	0	0
4	32022582	.	A	G	21	4	25	0	2	27	0	0
4	32583097	.	A	T	3	1	4	0	1	5	0	0
4	32583098	.	G	T	3	0	3	0	2	5	0	0
4	33019420	.	A	G	57	17	74	0	1	75	0	0
4	33020417	.	A	G	33	40	73	0	1	74	0	0
4	33945697	.	T	C	25	34	59	0	0	59	0	0
4	34950337	.	G	A	4	2	6	0	0	6	0	0
4	34950341	.	T	A	4	2	6	0	0	6	0	0
4	53566171	.	A	T	6	3	9	0	4	13	0	0
4	55081616	.	C	A	8	2	10	0	3	13	0	0
4	56870174	.	T	C	7	5	12	0	2	14	0	0
4	56947393	.	G	T	3	1	4	0	0	4	0	0
4	58436872	.	C	A	9	6	15	0	2	17	0	0
4	59472245	.	C	T	11	7	18	0	4	22	0	0
4	70140904	.	G	A	3	1	4	0	0	4	0	0
4	94830780	.	C	T	6	5	11	0	1	12	0	0
4	94834227	.	G	A	1	2	3	0	0	3	0	0
4	103075359	.	A	G	3	3	6	0	0	6	0	0
4	116453305	.	A	G	7	2	9	0	0	9	0	0
4	117731424	.	A	G	3	2	5	0	0	5	0	0
4	118483277	.	A	G	20	6	26	0	1	27	0	0
4	118484005	.	A	G	12	15	27	0	1	28	0	0
4	118484020	.	A	G	20	7	27	0	2	29	0	0
4	118484072	.	A	G	19	7	26	0	0	26	0	0
4	119080668	.	T	C	10	3	13	0	0	13	0	0
4	119080724	.	T	C	4	2	6	0	0	6	0	0
4	119135361	.	C	T	19	28	47	0	29	76	0	0
4	124837078	.	A	G	6	3	9	0	3	12	0	0
4	124837081	.	A	G	9	3	12	0	0	12	0	0
4	124838094	.	A	G	4	11	15	0	0	15	0	0
4	124838169	.	A	G	2	6	8	0	0	8	0	0
4	124838175	.	A	G	6	3	9	0	0	9	0	0
4	125945564	.	G	T	11	1	12	0	1	13	0	0
4	125945566	.	C	A	12	1	13	0	0	13	0	0
4	125982944	.	A	G	8	4	12	0	0	12	0	0
4	125984999	.	A	G	7	3	10	0	0	10	0	0
4	125985065	.	A	G	2	2	4	0	1	5	0	0
4	125985078	.	A	G	2	3	5	0	0	5	0	0
4	125985458	.	A	G	6	2	8	0	1	9	0	0
4	126072267	.	T	C	2	0	2	0	0	2	0	0
4	126929461	.	G	T	7	6	13	0	3	16	0	0
4	129062418	.	T	C	2	3	5	0	0	5	0	0
4	129407507	.	G	C	10	4	14	0	19	33	0	0
4	131677336	.	G	A	3	1	4	0	0	4	0	0
4	131679966	.	T	C	8	2	10	0	0	10	0	0
4	131839525	.	T	C	9	3	12	0	1	13	0	0
4	131948437	.	T	C	1	2	3	0	0	3	0	0
4	132219493	.	C	T	7	2	9	0	0	9	0	0
4	134625164	.	A	G	4	3	7	0	0	7	0	0
4	137347299	.	A	G	8	2	10	0	0	10	0	0
4	137987341	.	A	G	49	24	73	0	1	74	0	0
4	137987354	.	A	G	33	31	64	0	1	65	0	0
4	139694138	.	C	T	6	1	7	0	1	8	0	0
4	140678829	.	A	G	4	2	6	0	0	6	0	0
4	140678893	.	A	G	6	3	9	2	1	12	0	0
4	147907715	.	T	C	3	2	5	0	1	6	0	0
4	147907770	.	T	C	2	5	7	0	0	7	0	0
4	147907775	.	T	C	2	5	7	0	0	7	0	0
4	147907821	.	T	C	3	3	6	0	0	6	0	0
4	149202586	.	A	G	23	6	29	0	0	29	0	0
4	149202654	.	A	G	21	4	25	0	0	25	0	0
4	149203211	.	A	G	9	8	17	0	0	17	0	0
4	150189623	.	G	T	2	1	3	0	1	4	0	0
4	150189628	.	G	T	2	2	4	0	0	4	0	0
4	155705982	.	A	G	8	2	10	0	0	10	0	0
4	155706828	.	A	G	6	7	13	0	1	14	0	0
4	155800921	.	A	G	7	2	9	0	0	9	0	0
4	156095123	.	A	G	62	44	106	0	0	106	0	0
4	156105693	.	T	C	2	2	4	0	0	4	0	0
5	5833142	.	A	G	0	4	4	2	1	7	0	0
5	22930927	.	A	G	0	7	7	14	0	21	0	0
5	23627727	.	T	C	3	3	6	0	0	6	0	0
5	24649635	.	T	C	11	3	14	0	1	15	0	0
5	28047931	.	T	C	5	2	7	0	0	7	0	0
5	28057856	.	A	G	15	3	18	0	0	18	0	0
5	29658129	.	A	G	1	2	3	0	0	3	0	0
5	30780828	.	G	A	2	2	4	0	1	5	0	0
5	31330824	.	T	C	6	1	7	0	0	7	0	0
5	33149928	.	A	G	4	1	5	0	1	6	0	0
5	33149943	.	A	G	5	2	7	0	1	8	0	0
5	33572684	.	A	G	6	4	10	0	0	10	0	0
5	33573262	.	A	G	1	3	4	0	0	4	0	0
5	33573281	.	A	G	1	4	5	0	0	5	0	0
5	33573900	.	A	G	2	2	4	0	0	4	0	0
5	33575654	.	A	G	4	3	7	0	0	7	0	0
5	63803516	.	A	G	2	1	3	0	1	5	1	0
5	65605388	.	T	C	37	9	46	0	2	48	0	0
5	65605389	.	T	C	29	17	46	0	2	48	0	0
5	70909483	.	A	T	7	6	13	0	0	13	0	0
5	73469787	.	A	G	46	10	56	0	0	56	0	0
5	76357889	.	C	A	5	2	7	0	1	8	0	0
5	77555578	.	T	C	1	11	12	0	0	12	0	0
5	77555630	.	T	C	2	7	9	0	0	9	0	0
5	103358992	.	T	A	77	10	87	0	23	110	0	0
5	113235854	.	T	C	23	6	29	0	0	29	0	0
5	113235873	.	T	C	16	11	27	0	0	27	0	0
5	115437319	.	T	C	3	2	5	0	0	5	0	0
5	117412698	.	G	A	9	3	12	0	0	12	0	0
5	122546590	.	A	G	5	2	7	0	0	7	0	0
5	122872763	.	T	C	6	2	8	0	1	9	0	0
5	123295247	.	G	C	7	2	9	0	1	10	0	0
5	123386729	.	A	G	7	9	16	0	0	16	0	0
5	123495010	.	A	G	2	2	4	0	1	5	0	0
5	123880012	.	G	T	0	1	1	0	0	1	0	0
5	123880013	.	G	T	0	0	0	0	1	1	0	0
5	123880062	.	T	C	3	3	6	0	0	6	0	0
5	124144538	.	A	G	8	4	12	0	4	16	0	0
5	124792968	.	A	G	2	2	4	0	0	4	0	0
5	124940119	.	A	G	3	2	5	0	0	5	0	0
5	125533669	.	A	G	19	44	63	0	0	63	0	0
5	125533687	.	A	G	46	11	57	0	1	58	0	0
5	125533970	.	A	G	16	10	26	0	1	27	0	0
5	125533991	.	A	G	32	5	37	0	1	38	0	0
5	125534541	.	A	G	41	16	57	0	0	57	0	0
5	129797823	.	A	G	7	8	15	0	0	15	0	0
5	129798517	.	A	G	12	2	14	0	1	15	0	0
5	130014307	.	A	G	41	8	49	0	2	51	0	0
5	135193588	.	A	G	2	3	5	0	0	5	0	0
5	135193855	.	A	G	1	3	4	0	0	4	0	0
5	135437709	.	T	C	14	5	19	0	0	19	0	0
5	135437715	.	T	C	11	6	17	0	1	18	0	0
5	136941953	.	A	G	49	11	60	0	1	61	0	0
5	137142303	.	C	A	5	2	7	0	0	7	0	0
5	142655047	.	A	G	77	14	91	0	0	91	0	0
5	142855980	.	T	C	1	3	4	0	0	4	0	0
5	142856760	.	T	C	9	2	11	0	0	11	0	0
5	143381709	.	A	G	2	2	4	0	0	4	0	0
5	143382766	.	A	G	6	2	8	0	0	8	0	0
5	143751066	.	A	G	8	2	10	0	0	10	0	0
5	145126825	.	T	C	2	2	4	0	0	4	0	0
5	148269115	.	G	C	8	12	20	0	2	22	0	0
5	150573368	.	T	C	0	2	2	0	0	2	0	0
5	150573372	.	T	C	0	2	2	0	0	2	0	0
6	4760320	.	A	C	3	1	4	0	3	7	0	0
6	4760325	.	T	C	3	0	3	0	3	6	0	0
6	5485259	.	G	A	8	2	10	0	0	10	0	0
6	12041543	.	T	A	8	5	13	0	1	14	0	0
6	12555409	.	G	T	0	8	8	0	0	8	0	0
6	13869355	.	C	A	3	2	5	0	0	5	0	0
6	27363949	.	G	T	3	1	4	0	0	4	0	0
6	29714065	.	A	G	4	3	7	0	0	7	0	0
6	29761243	.	A	G	11	2	13	0	0	13	0	0
6	31492600	.	A	G	10	3	13	0	0	13	0	0
6	31492602	.	A	G	4	9	13	0	0	13	0	0
6	31492682	.	A	G	2	4	6	0	0	6	0	0
6	31492702	.	A	G	5	3	8	0	0	8	0	0
6	34130679	.	C	T	7	2	9	0	0	9	0	0
6	34751192	.	A	C	6	5	11	0	1	12	0	0
6	34751198	.	A	C	5	3	8	0	1	9	0	0
6	39312088	.	T	C	14	5	19	0	0	19	0	0
6	47279267	.	G	A	5	1	6	0	4	10	0	0
6	47279954	.	G	A	6	3	9	0	2	11	0	0
6	47846393	.	A	G	5	4	9	0	0	9	0	0
6	47846415	.	A	G	7	2	9	0	0	9	0	0
6	47848373	.	A	G	2	4	6	0	0	6	0	0
6	47848642	.	A	G	8	2	10	0	0	10	0	0
6	47848659	.	A	G	1	4	5	0	0	5	0	0
6	49231811	.	T	C	11	3	14	0	1	15	0	0
6	49231812	.	T	C	11	4	15	0	0	15	0	0
6	57512427	.	T	A	5	2	7	0	1	8	0	0
6	66517110	.	A	G	4	5	9	0	0	9	0	0
6	66517625	.	A	G	6	11	17	0	0	17	0	0
6	66517635	.	A	G	10	5	15	0	0	15	0	0
6	66517775	.	A	G	5	1	6	0	0	6	0	0
6	66517788	.	A	G	4	3	7	0	0	7	0	0
6	67273501	.	A	G	3	2	5	0	0	5	0	0
6	71768531	.	A	G	2	2	4	0	0	4	0	0
6	81938595	.	G	T	1	2	3	0	0	3	0	0
6	81938596	.	G	T	1	2	3	0	0	3	0	0
6	85932353	.	T	C	10	5	15	0	0	15	0	0
6	86393034	.	A	G	4	2	6	0	0	6	0	0
6	86978653	.	T	C	1	6	7	0	0	7	0	0
6	86978687	.	T	C	1	9	10	0	0	10	0	0
6	87112343	.	C	T	5	2	7	0	0	7	0	0
6	87606924	.	T	A	3	1	4	0	3	7	0	0
6	87795142	.	T	C	4	2	6	0	0	6	0	0
6	99670282	.	C	T	7	2	9	0	0	9	0	0
6	104703150	.	G	A	6	2	8	0	0	8	0	0
6	110617356	.	T	C	5	2	7	0	0	7	0	0
6	113054541	.	A	C	2	1	3	0	6	9	0	0
6	113054546	.	A	C	2	2	4	0	4	8	0	0
6	116614157	.	C	A	7	2	9	0	1	10	0	0
6	116661976	.	C	T	0	4	4	0	0	4	0	0
6	117974434	.	G	A	1	2	3	4	0	7	0	0
6	118442061	.	G	A	0	7	7	0	0	7	0	0
6	118512057	.	C	G	0	3	3	0	0	3	0	0
6	118512060	.	T	G	0	3	3	0	0	3	0	0
6	118517425	.	C	T	0	1	1	0	0	1	0	0
6	119410574	.	G	A	1	2	3	0	0	3	0	0
6	119824994	.	A	G	0	10	10	0	0	10	0	0
6	119939864	.	T	G	1	8	9	0	0	9	0	0
6	120177127	.	G	A	1	2	3	0	0	3	0	0
6	120866938	.	G	A	0	13	13	0	0	13	0	0
6	122716233	.	T	C	1	3	4	0	0	4	0	0
6	124894745	.	C	G	2	4	6	0	12	18	0	0
6	125127679	.	A	G	0	2	2	0	1	3	0	0
6	126619121	.	T	C	32	22	54	0	1	55	0	0
6	128517235	.	C	T	4	3	7	0	0	7	0	0
6	145808369	.	A	G	11	6	17	0	5	22	0	0
6	146012079	.	C	T	6	2	8	0	0	8	0	0
7	4149590	.	A	G	11	13	24	0	3	27	0	0
7	4149598	.	T	G	13	1	14	0	14	28	0	0
7	4796292	.	A	C	5	2	7	0	8	15	0	0
7	6196171	.	A	G	3	1	4	0	1	5	0	0
7	6357880	.	A	G	2	3	5	0	0	5	0	0
7	6678646	.	T	C	5	2	7	0	0	7	0	0
7	6967909	.	A	G	3	3	6	0	0	6	0	0
7	6967945	.	A	G	5	2	7	0	0	7	0	0
7	6968063	.	T	G	4	3	7	1	0	8	0	0
7	6969462	.	A	G	15	3	18	0	0	18	0	0
7	12706157	.	A	G	8	4	12	0	0	12	0	0
7	16141725	.	G	C	1	1	2	0	0	2	0	0
7	16529827	.	C	T	0	2	2	0	0	2	0	0
7	16619272	.	A	G	10	21	31	0	0	31	0	0
7	16619450	.	A	G	4	4	8	0	0	8	0	0
7	16619714	.	A	G	39	16	55	0	2	57	0	0
7	16650305	.	G	C	0	30	30	0	2	32	0	0
7	16650306	.	C	G	2	17	19	0	12	32	1	0
7	16651626	.	T	A	514	0	514	0	8	522	0	0
7	16681820	.	A	C	19	15	34	0	1	35	0	0
7	16681826	.	A	C	21	13	34	0	4	38	0	0
7	18692907	.	C	T	10	4	14	0	0	14	0	0
7	18732886	.	G	A	1	2	3	0	0	3	0	0
7	18873686	.	T	C	7	4	11	0	0	11	0	0
7	18957087	.	C	T	0	3	3	0	0	3	0	0
7	19090877	.	T	C	0	8	8	0	1	9	0	0
7	19240036	.	T	C	9	3	12	0	0	12	0	0
7	19366244	.	G	A	0	4	4	0	1	5	0	0
7	23840839	.	A	G	6	1	7	0	0	7	0	0
7	23927948	.	G	C	9	0	9	0	0	9	0	0
7	23974184	.	G	A	0	4	4	0	1	5	0	0
7	23974961	.	C	T	2	4	6	0	1	7	0	0
7	23975018	.	G	A	1	3	4	0	0	4	0	0
7	23975039	.	C	T	1	3	4	0	0	4	0	0
7	24710068	.	T	C	33	8	41	0	0	41	0	0
7	25370946	.	A	G	4	3	7	0	0	7	0	0
7	26904993	.	A	G	1	2	3	0	0	3	0	0
7	26905060	.	A	G	5	3	8	0	0	8	0	0
7	27226585	.	T	C	35	8	43	0	1	44	0	0
7	27281313	.	A	G	11	7	18	0	0	18	0	0
7	27663582	.	A	G	1	2	3	0	0	3	0	0
7	28167623	.	A	G	0	12	12	0	0	12	0	0
7	28853103	.	G	A	0	8	8	0	0	8	0	0
7	28859656	.	G	A	0	20	20	0	0	20	0	0
7	28868929	.	T	C	4	1	5	0	1	6	0	0
7	30445340	.	C	T	0	2	2	0	0	2	0	0
7	33914980	.	A	G	1	12	13	0	0	13	0	0
7	43174884	.	T	C	1	2	3	0	0	3	0	0
7	44461710	.	C	T	3	2	5	0	0	5	0	0
7	45032973	.	T	C	4	4	8	0	0	8	0	0
7	45484655	.	A	G	3	2	5	0	1	6	0	0
7	55627368	.	T	C	49	23	72	0	1	73	0	0
7	58875215	.	T	C	5	3	8	0	0	8	0	0
7	58899042	.	T	C	2	3	5	0	0	5	0	0
7	59331245	.	A	G	1	0	1	0	0	1	0	0
7	73387821	.	T	C	2	3	5	0	0	5	0	0
7	79206023	.	A	G	17	4	21	0	0	21	0	0
7	81253540	.	T	C	13	5	18	0	0	18	0	0
7	81521958	.	A	G	3	4	7	0	0	7	0	0
7	81522050	.	A	G	4	2	6	0	0	6	0	0
7	81522943	.	A	G	2	2	4	0	0	4	0	0
7	81533652	.	C	T	19	17	36	0	1	37	0	0
7	83274886	.	T	C	2	3	5	0	0	5	0	0
7	103988513	.	T	C	2	3	5	0	0	5	0	0
7	110655309	.	T	C	14	7	21	0	1	22	0	0
7	111950920	.	A	G	3	1	4	0	0	4	0	0
7	119383329	.	A	G	5	2	7	0	1	8	0	0
7	121733345	.	T	G	6	2	8	0	0	8	0	0
7	125316415	.	A	G	2	2	4	0	0	4	0	0
7	126456266	.	C	G	1	1	2	0	0	2	0	0
7	127178340	.	A	G	2	4	6	0	0	6	0	0
7	127178341	.	A	G	1	5	6	0	0	6	0	0
7	127262682	.	G	A	2	2	4	0	0	4	0	0
7	127519115	.	A	G	3	5	8	0	0	8	0	0
7	130360893	.	A	T	1	10	11	0	0	11	0	0
7	134485187	.	G	A	2	3	5	0	1	6	0	0
7	139685712	.	T	C	11	7	18	0	0	18	0	0
7	140391023	.	T	C	8	8	16	0	2	18	0	0
7	140471214	.	G	A	1	0	1	0	2	3	0	0
7	141013038	.	T	C	3	2	5	0	0	5	0	0
7	141635235	.	C	T	9	1	10	0	6	16	0	0
7	142207010	.	T	C	36	11	47	0	1	48	0	0
7	143963293	.	T	C	6	10	16	0	9	25	0	0
7	143963296	.	G	C	6	1	7	0	16	23	0	0
8	3588384	.	A	G	1	2	3	0	0	3	0	0
8	13336085	.	T	C	3	2	5	0	0	5	0	0
8	14140659	.	G	A	10	2	12	0	0	12	0	0
8	14140661	.	A	C	9	2	11	0	1	12	0	0
8	19732474	.	C	A	2	1	3	0	0	3	0	0
8	20030726	.	C	A	6	1	7	0	0	7	0	0
8	20717395	.	T	A	1	3	4	0	0	4	0	0
8	20727130	.	G	A	24	11	35	0	1	36	0	0
8	26517143	.	T	C	19	4	23	0	1	24	0	0
8	27537204	.	A	G	3	2	5	0	0	5	0	0
8	71826333	.	A	G	4	2	6	0	1	7	0	0
8	72670734	.	A	G	2	2	4	0	0	4	0	0
8	72977426	.	A	G	13	19	32	0	0	32	0	0
8	72977438	.	A	G	27	5	32	0	1	33	0	0
8	73269563	.	T	C	1	2	3	1	0	4	0	0
8	83590231	.	A	C	2	2	4	0	2	6	0	0
8	83590237	.	G	C	4	2	6	0	1	7	0	0
8	84982543	.	T	C	2	3	5	0	0	5	0	0
8	85784197	.	T	C	10	3	13	0	1	14	0	0
8	88898496	.	A	G	10	4	14	0	0	14	0	0
8	94743325	.	T	C	6	1	7	0	0	7	0	0
8	94743347	.	T	C	7	4	11	0	0	11	0	0
8	107744841	.	A	G	10	3	13	0	0	13	0	0
8	107744848	.	A	G	3	8	11	0	0	11	0	0
8	108144485	.	T	C	2	2	4	0	0	4	0	0
8	108144504	.	T	C	1	3	4	0	0	4	0	0
8	110400054	.	T	C	2	2	4	0	0	4	0	0
8	110817217	.	A	G	9	4	13	0	1	14	0	0
8	111646647	.	C	A	1	2	3	0	0	3	0	0
8	112177388	.	T	C	17	3	20	0	0	20	0	0
8	121822738	.	T	C	2	2	4	0	0	4	0	0
8	124147389	.	G	A	148	145	293	0	10	303	0	0
8	124261954	.	A	G	1	5	6	0	0	6	0	0
8	125620608	.	T	C	16	6	22	0	1	23	0	0
8	125620618	.	T	C	6	14	20	0	3	23	0	0
8	125620861	.	T	C	24	9	33	0	0	33	0	0
8	125620923	.	T	C	9	17	26	0	1	27	0	0
8	125620929	.	T	C	13	11	24	0	0	24	0	0
9	3387771	.	A	G	10	8	18	0	0	18	0	0
9	3760942	.	C	A	1	1	2	0	0	2	0	0
9	4456006	.	T	C	0	1	1	0	0	1	0	0
9	8022080	.	T	C	8	3	11	0	0	11	0	0
9	20513253	.	A	G	6	2	8	0	0	8	0	0
9	20513256	.	A	G	4	4	8	0	0	8	0	0
9	20938493	.	A	T	1	1	2	0	0	2	0	0
9	21122912	.	G	A	9	10	19	0	2	21	0	0
9	21929086	.	G	T	6	3	9	0	2	11	0	0
9	21929088	.	C	T	7	2	9	0	2	11	0	0
9	21935563	.	T	C	8	2	10	0	0	10	0	0
9	22189248	.	T	A	4	1	5	0	1	6	0	0
9	22189251	.	G	A	4	1	5	0	1	6	0	0
9	30982453	.	G	T	6	2	8	0	0	8	0	0
9	42163217	.	T	G	12	5	17	0	4	21	0	0
9	44204075	.	T	C	10	5	15	0	0	15	0	0
9	44204076	.	T	C	12	3	15	0	0	15	0	0
9	44205259	.	G	A	7	2	9	0	1	10	0	0
9	44419703	.	A	C	5	3	8	0	5	13	0	0
9	47764621	.	G	A	9	4	13	0	1	14	0	0
9	53286553	.	T	C	5	2	7	0	0	7	0	0
9	53311221	.	A	G	6	2	8	0	0	8	0	0
9	57051592	.	T	C	2	0	2	0	0	2	0	0
9	57658803	.	A	G	4	2	6	0	0	6	0	0
9	69923101	.	A	G	3	2	5	0	0	5	0	0
9	69923102	.	A	G	3	2	5	0	0	5	0	0
9	73387872	.	G	T	7	4	11	0	1	12	0	0
9	87073460	.	A	C	6	2	8	0	1	9	0	0
9	89794102	.	T	C	6	1	7	0	2	9	0	0
9	89794108	.	G	C	6	2	8	0	4	12	0	0
9	95448061	.	C	T	8	6	14	0	2	16	0	0
9	95939293	.	A	G	13	5	18	0	1	19	0	0
9	103232593	.	G	A	0	3	3	3	0	6	0	0
9	108215047	.	T	G	2	7	9	0	2	11	0	0
9	108341808	.	A	T	5	2	7	0	0	7	0	0
9	108409063	.	A	G	2	2	4	0	0	4	0	0
9	108448765	.	T	C	4	2	6	0	1	7	0	0
9	109660347	.	T	C	7	3	10	0	0	10	0	0
9	110086199	.	A	G	4	2	6	0	0	6	0	0
9	118753640	.	A	G	10	4	14	0	4	18	0	0
9	119878923	.	C	T	8	12	20	0	1	21	0	0
9	121540697	.	A	G	2	1	3	0	1	4	0	0
9	121584335	.	A	C	8	3	11	0	3	14	0	0
9	121584341	.	A	C	8	3	11	0	3	14	0	0
9	122660878	.	A	C	7	2	9	0	4	13	0	0
9	122660884	.	A	C	7	5	12	0	1	13	0	0
9	123525510	.	G	A	2	3	5	0	0	5	0	0
9	123526241	.	T	C	11	2	13	0	0	13	0	0
9	124034058	.	T	G	6	3	9	1	0	10	0	0
X	7774376	.	A	G	3	3	6	0	0	6	0	0
X	35462802	.	T	C	8	3	11	0	0	11	0	0
X	37697716	.	A	G	5	3	8	0	0	8	0	0
X	40743165	.	A	G	7	4	11	0	0	11	0	0
X	46899305	.	A	G	6	5	11	0	0	11	0	0
X	55633003	.	T	C	20	6	26	0	0	26	0	0
X	60231705	.	A	G	7	12	19	0	0	19	0	0
X	73270255	.	T	C	8	3	11	0	0	11	0	0
X	73270256	.	T	C	1	10	11	0	0	11	0	0
X	73270468	.	T	C	0	3	3	0	0	3	0	0
X	73328787	.	A	G	2	3	5	0	0	5	0	0
X	73329444	.	A	G	1	3	4	0	0	4	0	0
X	73329453	.	A	G	4	4	8	0	0	8	0	0
X	73331342	.	A	G	3	2	5	0	0	5	0	0
X	94984236	.	C	T	13	3	16	0	0	16	0	0
X	102620158	.	T	C	2	2	4	0	0	4	0	0
X	102620159	.	T	C	2	2	4	0	0	4	0	0
X	102623385	.	T	C	4	3	7	0	0	7	0	0
X	103325981	.	A	G	14	3	17	0	3	21	1	0
X	119815801	.	T	C	9	2	11	0	0	11	0	0
X	119819641	.	C	T	5	2	7	0	0	7	0	0
X	133489294	.	T	C	10	3	13	0	0	13	0	0
X	133489300	.	T	C	7	5	12	0	0	12	0	0
X	133490062	.	T	C	4	2	6	0	0	6	0	0
X	145978689	.	A	G	31	8	39	0	1	40	0	0
X	149766871	.	T	C	15	9	24	0	3	27	0	0
X	149767614	.	T	C	30	41	71	0	1	72	0	0
X	160617936	.	C	T	2	2	4	0	0	4	0	0
X	161815172	.	A	G	4	2	6	0	1	7	0	0
X	162761028	.	T	C	3	2	5	0	1	6	0	0
X	164972992	.	A	G	3	2	5	0	0	5	0	0
Y	1016394	.	A	G	15	14	29	0	3	32	0	0
