contig	position	variantID	refAllele	altAllele	refCount	altCount	totalCount	lowMAPQDepth	lowBaseQDepth	rawDepth	otherBases	improperPairs
1	10101214	.	T	C	1	3	4	0	0	4	0	0
1	10101247	.	T	C	6	4	10	0	0	10	0	0
1	10101253	.	T	C	8	3	11	0	0	11	0	0
1	13696043	.	T	C	8	2	10	3	0	13	0	0
1	16717060	.	T	C	7	3	10	0	0	10	0	0
1	22031785	.	T	C	9	6	15	0	0	15	0	0
1	33835490	.	T	C	11	3	14	0	0	14	0	0
1	38024745	.	G	A	9	3	12	0	1	13	0	0
1	40064512	.	T	C	9	2	11	0	4	15	0	0
1	42789922	.	A	G	5	2	7	0	0	7	0	0
1	51506146	.	T	C	1	2	3	0	0	3	0	0
1	51507738	.	T	C	1	2	3	0	0	3	0	0
1	51507771	.	T	C	2	3	5	0	0	5	0	0
1	52542746	.	T	C	3	2	5	0	0	5	0	0
1	55193265	.	G	A	1	3	4	0	0	4	0	0
1	55193270	.	G	A	2	4	6	0	0	6	0	0
1	59913367	.	A	G	60	29	89	0	3	92	0	0
1	60517747	.	A	G	54	34	88	1	13	102	0	0
1	66711873	.	A	G	87	54	141	0	7	148	0	0
1	75398649	.	A	G	22	6	28	0	2	30	0	0
1	75398708	.	A	G	3	26	29	0	2	31	0	0
1	86276528	.	T	C	20	4	24	0	1	25	0	0
1	86836917	.	T	C	2	2	4	16	1	21	0	0
1	88188057	.	A	C	1	3	4	0	0	4	0	0
1	88188745	.	T	A	1	3	4	0	0	4	0	0
1	88188846	.	T	G	3	2	5	0	0	5	0	0
1	88188916	.	C	A	3	2	5	0	1	6	0	0
1	88189404	.	C	T	3	2	5	0	0	5	0	0
1	88189486	.	C	A	5	2	7	0	0	7	0	0
1	88189784	.	A	G	1	2	3	0	1	4	0	0
1	88190006	.	T	A	3	1	4	0	0	4	0	0
1	88190661	.	G	C	2	4	6	0	0	6	0	0
1	88191237	.	A	C	15	47	62	0	4	66	0	0
1	88191281	.	A	G	72	8	80	0	3	83	0	0
1	88191320	.	C	T	15	45	60	0	0	60	0	0
1	88191706	.	G	A	42	8	50	0	0	50	0	0
1	88191710	.	T	C	14	34	48	0	3	51	0	0
1	88191744	.	C	A	48	9	57	0	2	59	0	0
1	88191864	.	G	T	61	11	72	0	1	73	0	0
1	88192008	.	C	T	56	14	70	0	9	79	0	0
1	88192048	.	G	C	17	34	51	0	0	51	0	0
1	88192098	.	G	A	76	16	92	0	1	93	0	0
1	88192180	.	G	T	64	12	76	0	4	80	0	0
1	88192184	.	T	A	70	14	84	0	2	86	0	0
1	88192243	.	A	G	8	55	63	0	1	64	0	0
1	88192700	.	G	A	10	20	30	0	0	30	0	0
1	88192756	.	G	A	13	53	66	0	1	67	0	0
1	88192980	.	A	G	8	50	58	4	3	65	0	0
1	88193031	.	C	G	17	29	46	2	1	49	0	0
1	88193194	.	C	T	5	8	13	7	1	21	0	0
1	88193568	.	A	C	3	4	7	38	0	45	0	0
1	88193917	.	G	A	9	14	23	24	0	47	0	0
1	88194314	.	C	A	48	12	60	3	0	63	0	0
1	88197053	.	T	C	6	6	12	0	0	12	0	0
1	88197991	.	A	G	15	39	54	0	1	55	0	0
1	88200718	.	C	A	2	16	18	0	1	19	0	0
1	88200832	.	C	T	7	19	26	0	0	26	0	0
1	88202664	.	A	G	1	3	4	3	0	7	0	0
1	88202772	.	A	T	6	2	8	1	0	9	0	0
1	94396482	.	A	G	2	2	4	13	0	17	0	0
1	97877103	.	C	T	0	3	3	3	1	7	0	0
1	132927928	.	T	C	6	2	8	0	0	8	0	0
1	133065748	.	A	G	57	11	68	0	4	72	0	0
1	133067453	.	T	C	15	4	19	0	1	22	2	0
1	156255182	.	T	C	6	18	24	0	0	24	0	0
1	160835342	.	T	C	5	4	9	0	0	9	0	0
1	160835343	.	T	C	5	4	9	0	0	9	0	0
1	160840574	.	T	C	6	2	8	0	2	10	0	0
1	160842749	.	T	C	10	2	12	0	0	12	0	0
1	165059169	.	T	C	3	2	5	0	0	5	0	0
1	165061910	.	T	C	2	2	4	0	0	4	0	0
1	171716688	.	A	G	1	2	3	0	0	3	0	0
1	178780229	.	T	C	3	3	6	0	0	6	0	0
1	180493439	.	G	C	4	1	5	0	1	6	0	0
1	180924020	.	T	C	28	9	37	0	2	39	0	0
1	183190594	.	A	G	14	17	31	0	0	31	0	0
1	183190595	.	A	G	23	6	29	0	1	30	0	0
1	183190682	.	A	G	12	9	21	0	1	22	0	0
10	7524278	.	T	C	1	2	3	0	0	3	0	0
10	21001216	.	A	G	1	2	3	0	1	4	0	0
10	48972272	.	A	G	3	2	5	0	0	5	0	0
10	49118546	.	T	C	24	3	27	0	1	28	0	0
10	49118584	.	T	C	8	14	22	0	1	23	0	0
10	49118640	.	T	C	10	12	22	0	0	22	0	0
10	49148885	.	T	C	8	43	51	0	1	52	0	0
10	52217533	.	A	G	1	2	3	0	0	3	0	0
10	57383252	.	A	G	3	2	5	0	0	5	0	0
10	57391874	.	C	T	15	8	23	0	1	24	0	0
10	73038503	.	T	G	1	2	3	1	0	4	0	0
10	81182083	.	T	C	22	3	25	0	0	25	0	0
10	81366434	.	G	T	6	5	11	0	2	13	0	0
10	82062115	.	T	C	20	21	41	0	0	41	0	0
10	82486401	.	T	C	17	2	19	0	0	19	0	0
10	93582974	.	C	A	2	1	3	0	1	4	0	0
10	93801926	.	T	C	7	4	11	0	0	11	0	0
10	93802019	.	G	A	12	2	14	0	0	14	0	0
10	93802028	.	T	C	12	2	14	0	0	14	0	0
10	94057224	.	A	G	18	12	30	0	1	31	0	0
10	94057234	.	A	G	21	4	25	0	0	25	0	0
10	126903751	.	T	C	91	20	111	0	1	112	0	0
10	127038297	.	T	C	3	2	5	0	0	5	0	0
10	128157141	.	T	C	5	3	8	0	0	8	0	0
10	128505929	.	T	C	9	3	12	0	0	12	0	0
11	3079274	.	C	T	8	3	11	3	0	14	0	0
11	4091399	.	T	C	16	3	19	0	0	19	0	0
11	4091432	.	T	C	17	4	21	0	1	22	0	0
11	20178606	.	T	C	17	4	21	0	0	21	0	0
11	30229683	.	C	T	5	2	7	0	5	12	0	0
11	30229687	.	C	T	7	1	8	0	3	11	0	0
11	33226103	.	T	C	1	2	3	0	0	3	0	0
11	41389909	.	T	G	0	1	1	0	2	3	0	0
11	42021769	.	A	T	1	3	4	0	0	4	0	0
11	43572939	.	A	G	9	4	13	0	0	13	0	0
11	43572970	.	A	G	11	4	15	0	0	15	0	0
11	43573028	.	A	G	3	2	5	0	0	5	0	0
11	46130068	.	A	C	7	2	9	0	3	12	0	0
11	46163470	.	T	C	105	446	551	0	12	563	0	0
11	51548419	.	T	C	3	2	5	0	0	5	0	0
11	54730814	.	T	C	24	5	29	0	0	29	0	0
11	59096899	.	A	G	10	3	13	0	0	13	0	0
11	62032236	.	A	G	3	2	5	0	0	5	0	0
11	69674128	.	A	G	19	2	21	0	0	21	0	0
11	69716092	.	T	G	19	6	25	0	15	40	0	0
11	69922901	.	A	G	8	6	14	0	1	15	0	0
11	69922910	.	A	G	14	3	17	0	0	17	0	0
11	69923489	.	A	G	8	2	10	0	0	10	0	0
11	69923490	.	A	G	5	3	8	0	0	8	0	0
11	69925201	.	A	G	7	2	9	0	1	10	0	0
11	69925276	.	A	G	10	2	12	0	0	12	0	0
11	69927865	.	A	G	7	3	10	0	1	11	0	0
11	69927869	.	A	G	1	8	9	0	0	9	0	0
11	72687147	.	A	G	10	3	13	0	0	13	0	0
11	74747599	.	T	C	1	4	5	0	0	5	0	0
11	75067258	.	T	C	35	7	42	0	0	42	0	0
11	75467187	.	G	T	5	4	9	0	0	9	0	0
11	77426880	.	T	C	76	11	87	0	1	88	0	0
11	77873983	.	C	G	14	3	17	0	3	20	0	0
11	78187443	.	A	G	7	4	11	0	1	12	0	0
11	78432329	.	C	A	17	1	18	0	5	23	0	0
11	82854512	.	A	G	11	2	13	0	0	13	0	0
11	83479402	.	T	C	1	2	3	0	0	3	0	0
11	86521633	.	T	C	1	3	4	7	1	12	0	0
11	87013235	.	A	G	19	4	23	0	0	23	0	0
11	87013245	.	A	G	25	2	27	0	0	27	0	0
11	87269321	.	T	C	1	2	3	0	0	3	0	0
11	94431300	.	T	C	11	3	14	0	0	14	0	0
11	94431318	.	T	C	12	6	18	0	0	18	0	0
11	95962333	.	T	C	6	2	8	0	0	8	0	0
11	97535690	.	T	C	11	5	16	0	0	16	0	0
11	100134254	.	G	T	1	2	3	5	0	8	0	0
11	101089802	.	T	C	15	10	25	0	1	26	0	0
11	104222913	.	T	A	5	2	7	0	0	7	0	0
11	115807292	.	T	C	1	2	3	0	0	3	0	0
11	116471963	.	T	C	9	33	42	0	2	44	0	0
11	119265670	.	C	G	9	1	10	0	0	10	0	0
12	3454168	.	A	G	60	16	76	20	1	97	0	0
12	3454248	.	A	G	20	32	52	15	6	73	0	0
12	17479809	.	A	G	14	19	33	0	0	33	0	0
12	46747117	.	T	C	29	11	40	0	1	41	0	0
12	54718540	.	T	C	37	7	44	0	1	45	0	0
12	54719070	.	T	C	39	5	44	0	2	46	0	0
12	54719142	.	T	C	38	7	45	0	2	47	0	0
12	55102739	.	T	C	5	2	7	0	0	7	0	0
12	65113982	.	T	C	8	2	10	0	0	10	0	0
12	69244102	.	A	G	21	11	32	0	0	32	0	0
12	69347175	.	A	G	2	3	5	0	0	5	0	0
12	71041403	.	A	G	9	45	54	0	2	56	0	0
12	71041945	.	A	G	24	4	28	0	3	31	0	0
12	73975614	.	A	G	1	6	7	0	0	7	0	0
12	73975686	.	A	G	1	2	3	0	0	3	0	0
12	75677928	.	A	G	3	5	8	6	1	15	0	0
12	75678010	.	C	T	3	2	5	9	0	14	0	0
12	76366551	.	T	C	9	2	11	0	0	11	0	0
12	80154594	.	C	T	7	2	9	0	6	15	0	0
12	81245339	.	G	A	14	21	35	0	1	36	0	0
12	81419007	.	C	A	1	4	5	0	0	5	0	0
12	87467465	.	A	C	0	3	3	1	0	4	0	0
12	87467472	.	G	A	9	2	11	1	0	12	0	0
12	87480641	.	T	C	3	2	5	0	0	5	0	0
12	98169693	.	A	G	3	1	4	0	3	7	0	0
12	101886131	.	T	C	18	5	23	0	0	23	0	0
12	101887890	.	T	C	18	7	25	0	0	25	0	0
12	108756817	.	T	C	5	2	7	0	0	7	0	0
12	109706996	.	A	G	5	2	7	0	0	7	0	0
12	112942561	.	C	A	12	2	14	0	0	14	0	0
12	112942562	.	C	A	11	2	13	0	2	15	0	0
12	113120854	.	A	C	1	3	4	0	0	4	0	0
12	118195513	.	A	G	4	2	6	0	0	6	0	0
13	3588114	.	T	C	12	1	13	0	7	20	0	0
13	8901801	.	T	C	19	10	29	1	1	31	0	0
13	13534327	.	T	C	1	2	3	0	0	3	0	0
13	14225628	.	T	C	41	13	54	0	1	55	0	0
13	14226674	.	T	C	63	7	70	0	3	73	0	0
13	16205845	.	A	T	9	2	11	0	1	12	0	0
13	17978854	.	T	C	15	2	17	0	0	17	0	0
13	17979133	.	T	C	4	6	10	0	0	10	0	0
13	21574169	.	T	C	9	7	16	0	0	16	0	0
13	21574188	.	T	C	13	4	17	0	0	17	0	0
13	24998572	.	A	G	5	3	8	0	0	8	0	0
13	34528682	.	C	T	9	2	11	0	1	12	0	0
13	38228991	.	A	G	1	2	3	0	0	3	0	0
13	49685058	.	A	G	1	5	6	0	0	6	0	0
13	63448369	.	A	G	10	2	12	0	0	12	0	0
13	63448526	.	A	G	9	4	13	0	0	13	0	0
13	63690911	.	C	T	4	11	15	0	1	16	0	0
13	64438124	.	T	C	18	7	25	0	0	25	0	0
13	67762001	.	A	G	5	2	7	0	0	7	0	0
13	67967482	.	T	C	1	2	3	0	0	3	0	0
13	67967722	.	T	C	3	2	5	0	0	5	0	0
13	67967775	.	T	C	1	2	3	0	0	3	0	0
13	78426739	.	T	C	4	2	6	0	0	6	0	0
13	92577452	.	G	A	13	2	15	0	10	25	0	0
13	100156147	.	A	G	10	4	14	0	0	15	1	0
13	103901108	.	A	G	12	5	17	0	0	17	0	0
13	107861323	.	C	T	11	4	15	0	2	17	0	0
13	118515925	.	T	C	8	2	10	0	0	10	0	0
13	119625401	.	G	T	22	7	29	0	0	29	0	0
13	120252066	.	T	C	6	4	10	0	0	10	0	0
14	9647289	.	A	G	95	11	106	0	2	108	0	0
14	10058181	.	A	G	155	40	195	0	2	197	0	0
14	14533725	.	T	C	2	10	12	0	0	12	0	0
14	20418433	.	A	G	11	5	16	0	0	16	0	0
14	20418440	.	A	G	14	3	17	0	0	17	0	0
14	21846832	.	A	G	23	44	67	0	2	69	0	0
14	21847779	.	A	G	96	16	112	0	2	114	0	0
14	26381874	.	T	C	6	3	9	0	3	12	0	0
14	27205403	.	A	G	15	2	17	0	0	17	0	0
14	29788070	.	T	C	21	6	27	0	0	27	0	0
14	29788078	.	T	C	22	10	32	0	0	32	0	0
14	32018582	.	A	G	50	10	60	0	2	62	0	0
14	51013458	.	T	C	17	7	24	0	0	24	0	0
14	51108706	.	A	G	4	2	6	0	0	6	0	0
14	51109987	.	A	G	2	2	4	0	0	4	0	0
14	54532669	.	T	C	6	2	8	0	0	8	0	0
14	55749057	.	A	G	18	4	22	0	0	22	0	0
14	62778450	.	A	G	1	5	6	3	1	10	0	0
14	65291200	.	A	G	22	4	26	0	25	51	0	0
14	75957159	.	T	C	25	9	34	0	0	34	0	0
14	79709368	.	T	C	3	2	5	0	0	5	0	0
14	79773830	.	T	A	9	2	11	0	0	11	0	0
14	103584115	.	T	C	26	20	46	0	1	47	0	0
14	121273016	.	A	G	7	5	12	0	0	12	0	0
15	5150309	.	T	C	3	6	9	22	0	31	0	0
15	8187674	.	A	G	3	8	11	0	0	11	0	0
15	8188973	.	A	G	6	3	9	0	1	10	0	0
15	47833556	.	A	T	10	2	12	0	0	12	0	0
15	55116094	.	A	G	13	2	15	0	1	16	0	0
15	58695035	.	T	C	22	5	27	0	0	27	0	0
15	66158075	.	T	C	17	12	29	0	0	29	0	0
15	68973014	.	C	A	8	6	14	0	3	17	0	0
15	75525421	.	T	C	4	2	6	0	0	6	0	0
15	79496119	.	T	C	1	2	3	0	0	3	0	0
15	79571382	.	G	A	48	11	59	0	19	78	0	0
15	81341195	.	A	G	11	2	13	0	2	15	0	0
15	81799307	.	G	A	34	5	39	0	13	52	0	0
15	82015818	.	A	G	4	2	6	0	0	6	0	0
15	83829445	.	C	T	3	2	5	0	0	5	0	0
15	84100970	.	A	G	10	2	12	0	0	12	0	0
15	84944342	.	A	G	5	2	7	0	0	7	0	0
15	85169425	.	A	G	5	1	6	0	0	6	0	0
15	85169426	.	C	A	5	1	6	0	0	6	0	0
15	98634993	.	T	C	26	44	70	0	1	71	0	0
15	98731431	.	T	C	31	6	37	0	0	37	0	0
15	99142536	.	T	C	16	2	18	2	0	20	0	0
15	99626091	.	A	G	10	7	17	0	0	17	0	0
15	100495079	.	T	C	1	4	5	0	0	5	0	0
16	3680985	.	T	C	29	7	36	0	0	36	0	0
16	4844012	.	T	C	1	2	3	0	0	3	0	0
16	13520445	.	A	G	33	4	37	0	1	38	0	0
16	13521450	.	T	A	0	1	1	0	3	4	0	0
16	13651947	.	T	C	27	3	30	0	0	30	0	0
16	17321752	.	A	G	17	6	23	0	0	23	0	0
16	18653678	.	A	G	65	20	85	0	2	87	0	0
16	19942498	.	A	G	53	20	73	0	4	77	0	0
16	20363104	.	A	G	12	2	14	0	1	15	0	0
16	20363121	.	A	G	7	6	13	0	0	13	0	0
16	20363153	.	A	G	4	2	6	0	0	6	0	0
16	30330773	.	T	C	16	4	20	0	0	20	0	0
16	31103404	.	T	C	1	1	2	0	0	2	0	0
16	32119150	.	A	G	22	18	40	0	0	40	0	0
16	34975861	.	T	C	6	0	6	0	7	13	0	0
16	34975866	.	A	C	7	3	10	0	5	15	0	0
16	43691361	.	T	C	5	3	8	0	0	8	0	0
16	87230813	.	T	C	20	2	22	0	1	23	0	0
16	87230814	.	T	C	18	3	21	0	2	23	0	0
16	87299868	.	A	G	1	2	3	0	0	3	0	0
16	87299874	.	A	G	1	2	3	0	0	3	0	0
16	87737431	.	T	C	1	2	3	0	0	3	0	0
16	91453021	.	A	G	85	18	103	0	2	105	0	0
16	97658408	.	T	C	5	2	7	0	0	7	0	0
17	3094530	.	A	G	4	2	6	19	0	25	0	0
17	12901727	.	C	A	6	3	9	0	6	15	0	0
17	15741073	.	A	G	4	6	10	0	0	10	0	0
17	24381413	.	T	C	4	4	8	0	0	8	0	0
17	24397327	.	T	C	13	16	29	0	1	30	0	0
17	27721769	.	T	C	19	4	23	0	0	23	0	0
17	28538354	.	A	G	1	2	3	0	0	3	0	0
17	29521001	.	A	G	9	4	13	0	1	14	0	0
17	31875349	.	T	C	2	2	4	0	0	4	0	0
17	32280731	.	A	G	8	7	15	0	0	15	0	0
17	33552004	.	T	C	19	9	28	0	0	28	0	0
17	33904744	.	T	C	3	2	5	0	0	5	0	0
17	33966501	.	T	C	44	9	53	194	10	257	0	0
17	34147531	.	A	G	27	11	38	0	0	38	0	0
17	35555021	.	C	T	1	2	3	0	1	4	0	0
17	36317455	.	T	C	4	4	8	0	1	9	0	0
17	36317456	.	T	C	3	5	8	0	1	9	0	0
17	40158498	.	T	C	3749	4731	8480	3	162	8979	334	0
17	40159543	.	T	C	22	228	250	1	7	258	0	0
17	45973875	.	T	C	40	99	139	0	12	151	0	0
17	46727643	.	A	G	6	2	8	0	0	8	0	0
17	46727656	.	A	G	6	2	8	0	0	8	0	0
17	47996812	.	T	C	1	2	3	0	1	4	0	0
17	50586902	.	G	A	7	2	9	0	0	9	0	0
17	80352912	.	T	C	5	3	8	0	0	8	0	0
17	95067479	.	T	C	22	24	46	0	0	46	0	0
17	95068552	.	T	C	65	10	75	0	0	75	0	0
18	6792802	.	A	G	24	4	28	0	1	29	0	0
18	24097917	.	A	G	11	4	15	0	0	15	0	0
18	25155686	.	A	G	1	0	1	0	0	1	0	0
18	32235928	.	A	G	6	2	8	0	1	9	0	0
18	32235930	.	A	G	5	2	7	0	1	8	0	0
18	32235981	.	A	G	11	5	16	1	0	17	0	0
18	32236019	.	A	G	12	6	18	1	2	21	0	0
18	32561134	.	A	G	39	13	52	0	0	52	0	0
18	34998034	.	G	A	1	4	5	0	1	6	0	0
18	35743341	.	A	G	10	2	12	0	1	13	0	0
18	35807586	.	T	C	78	8	86	0	2	88	0	0
18	54117879	.	A	G	0	2	2	0	2	4	0	0
18	61328635	.	T	C	8	2	10	0	1	11	0	0
18	65610148	.	A	G	5	6	11	0	0	11	0	0
18	65610162	.	A	G	7	6	13	0	0	13	0	0
18	78798296	.	C	T	8	2	10	0	0	10	0	0
19	3916222	.	A	G	11	3	14	0	1	15	0	0
19	3917362	.	A	G	6	3	9	0	1	10	0	0
19	4325587	.	T	C	2	2	4	0	0	4	0	0
19	4813117	.	T	C	3	5	8	0	1	9	0	0
19	5015429	.	A	G	5	4	9	0	0	9	0	0
19	5016322	.	A	G	1	2	3	0	1	4	0	0
19	6895783	.	T	C	5	3	8	0	1	9	0	0
19	7515480	.	A	G	26	9	35	0	0	35	0	0
19	7937498	.	G	T	1	0	1	3	9	13	0	0
19	8660724	.	A	G	20	5	25	0	1	26	0	0
19	10223060	.	T	C	46	86	132	0	5	137	0	0
19	12441626	.	A	G	38	4	42	0	4	46	0	0
19	21262420	.	T	C	6	3	9	0	0	9	0	0
19	24853110	.	A	T	9	2	11	51	1	63	0	0
19	41261230	.	C	T	1	2	3	0	0	3	0	0
19	43429601	.	A	G	22	16	38	0	1	39	0	0
19	43429686	.	A	G	40	6	46	0	1	47	0	0
19	43429753	.	A	G	48	10	58	0	1	59	0	0
19	44203975	.	A	T	2	2	4	0	0	4	0	0
19	44203976	.	T	C	2	2	4	0	0	4	0	0
19	44993669	.	T	C	68	10	78	0	3	81	0	0
19	44993727	.	T	C	79	9	88	0	1	89	0	0
19	45806535	.	A	G	4	1	5	0	3	8	0	0
19	47071354	.	G	T	2	2	4	0	0	4	0	0
19	47071357	.	G	T	2	1	3	0	1	4	0	0
19	61112853	.	A	G	10	2	12	0	0	12	0	0
2	14152860	.	A	G	38	7	45	0	1	46	0	0
2	17401950	.	T	C	5	2	7	0	0	7	0	0
2	22477570	.	T	C	3	2	5	24	1	30	0	0
2	22478316	.	A	G	0	2	2	10	1	13	0	0
2	22478326	.	G	T	1	2	3	9	0	12	0	0
2	22478526	.	A	G	3	3	6	12	0	18	0	0
2	22478637	.	A	G	0	2	2	11	4	17	0	0
2	22478823	.	G	A	2	1	3	16	3	22	0	0
2	22479057	.	T	C	0	1	1	5	3	10	1	0
2	22479435	.	G	A	2	2	4	15	5	24	0	0
2	26278314	.	A	G	4	3	7	0	0	7	0	0
2	26846568	.	T	C	6	5	11	1	0	12	0	0
2	27153718	.	T	C	6	4	10	0	0	10	0	0
2	30920396	.	T	C	25	3	28	0	0	28	0	0
2	31505906	.	A	G	10	2	12	0	0	12	0	0
2	31937444	.	A	G	14	2	16	0	0	16	0	0
2	32175476	.	T	C	5	2	7	0	0	7	0	0
2	32196762	.	A	G	90	15	105	0	0	105	0	0
2	38615418	.	T	C	9	2	11	0	0	11	0	0
2	38903117	.	T	C	7	2	9	0	0	9	0	0
2	40445910	.	G	T	1	6	7	5	0	12	0	0
2	40445978	.	T	C	0	3	3	5	3	11	0	0
2	40446129	.	C	G	1	3	4	11	3	18	0	0
2	67952998	.	A	T	3	16	19	0	1	20	0	0
2	80668540	.	G	A	1	2	3	9	1	13	0	0
2	91043632	.	A	G	55	14	69	0	3	72	0	0
2	102612558	.	T	A	244	59	303	0	27	330	0	0
2	104511430	.	T	C	27	4	31	0	1	32	0	0
2	112185846	.	A	G	5	5	10	0	0	10	0	0
2	112185852	.	A	G	9	2	11	0	0	11	0	0
2	118700801	.	A	G	13	2	15	0	1	16	0	0
2	120451649	.	A	G	41	5	46	3	2	51	0	0
2	121015462	.	A	G	3	3	6	0	0	6	0	0
2	121178337	.	T	C	4	2	6	0	0	6	0	0
2	121374228	.	A	G	1	3	4	0	0	4	0	0
2	121374748	.	A	G	7	2	9	0	0	9	0	0
2	121374751	.	A	G	7	2	9	0	0	9	0	0
2	121374834	.	A	G	6	3	9	0	0	9	0	0
2	127126729	.	A	G	4	2	6	0	1	7	0	0
2	132151800	.	A	G	65	392	457	1	7	465	0	0
2	149585866	.	C	A	0	2	2	0	0	2	0	0
2	149585867	.	G	A	1	2	3	0	0	3	0	0
2	152114942	.	A	G	2	6	8	0	0	8	0	0
2	153459246	.	T	C	2	6	8	0	0	8	0	0
2	154379850	.	A	G	42	13	55	0	0	55	0	0
2	154428255	.	T	C	6	2	8	0	0	8	0	0
2	157400030	.	T	C	138	18	156	8	3	167	0	0
2	158225545	.	A	G	551	98	649	0	7	656	0	0
2	158226873	.	A	G	175	516	691	0	33	724	0	0
2	163309459	.	T	C	14	7	21	0	2	23	0	0
2	164953669	.	T	C	57	6	63	0	2	65	0	0
2	164953773	.	T	C	51	15	66	0	2	68	0	0
2	166408278	.	A	G	20	8	28	0	0	28	0	0
2	167450245	.	A	T	1	2	3	178	0	181	0	0
2	168055452	.	T	C	7	2	9	0	0	9	0	0
2	169913325	.	A	G	2	5	7	0	0	7	0	0
2	169913421	.	A	G	9	3	12	0	0	12	0	0
2	170305490	.	T	C	1	3	4	19	0	23	0	0
2	174169694	.	A	G	148	34	182	2	4	188	0	0
3	19279149	.	T	C	22	3	25	0	0	25	0	0
3	32566339	.	A	G	4	3	7	0	1	8	0	0
3	32636549	.	T	C	13	4	17	0	1	18	0	0
3	36146600	.	A	G	1	3	4	4	0	8	0	0
3	40748697	.	A	G	61	8	69	21	4	94	0	0
3	57551908	.	T	C	2	3	5	0	0	5	0	0
3	65866372	.	A	G	8	2	10	0	0	10	0	0
3	65868019	.	A	G	10	2	12	0	0	12	0	0
3	79551611	.	T	C	10	2	12	0	0	12	0	0
3	80599593	.	T	C	37	53	90	0	2	92	0	0
3	80613850	.	T	C	28	7	35	0	0	35	0	0
3	80614215	.	T	C	163	68	231	0	2	233	0	0
3	87814274	.	A	G	5	1	6	0	5	11	0	0
3	87814276	.	C	G	7	0	7	0	5	12	0	0
3	89090052	.	G	A	7	2	9	0	4	13	0	0
3	90389599	.	A	G	2	2	4	0	0	4	0	0
3	94927231	.	A	G	1	2	3	0	0	3	0	0
3	95089973	.	G	A	9	3	12	0	2	14	0	0
3	96127520	.	T	C	2	2	4	0	1	5	0	0
3	96539776	.	A	G	6	17	23	0	3	26	0	0
3	96540029	.	A	G	34	5	39	0	1	40	0	0
3	102973406	.	A	G	71	15	86	0	1	87	0	0
3	104835351	.	A	G	7	6	13	0	1	14	0	0
3	104835352	.	A	G	10	4	14	0	0	14	0	0
3	108341768	.	T	C	4	2	6	0	0	6	0	0
3	122426602	.	G	T	5	2	7	22	0	29	0	0
3	135112631	.	T	C	72	11	83	0	0	83	0	0
3	138265030	.	A	G	15	3	18	0	0	18	0	0
3	151505238	.	A	G	1	2	3	0	0	3	0	0
4	21836550	.	A	G	43	12	55	0	0	55	0	0
4	21911309	.	A	G	30	6	36	0	0	36	0	0
4	21911886	.	A	G	20	3	23	0	0	23	0	0
4	32022582	.	A	G	51	6	57	0	2	59	0	0
4	33019420	.	A	G	118	38	156	1	4	161	0	0
4	33020417	.	A	G	78	84	162	0	2	164	0	0
4	41518514	.	T	C	220	45	265	0	8	273	0	0
4	55081611	.	C	A	14	0	14	0	8	22	0	0
4	62342224	.	A	G	20	3	23	0	0	23	0	0
4	62371673	.	T	C	5	3	8	0	0	8	0	0
4	69844043	.	C	T	2	3	5	14	2	21	0	0
4	75860914	.	G	T	6	6	12	0	6	18	0	0
4	86495344	.	G	T	91	14	105	0	3	108	0	0
4	103021909	.	A	G	25	6	31	0	1	32	0	0
4	108198313	.	A	G	9	5	14	0	0	14	0	0
4	108491569	.	T	C	9	2	11	0	0	11	0	0
4	116410052	.	T	C	21	3	24	0	1	25	0	0
4	118484005	.	A	G	12	34	46	0	0	46	0	0
4	118484020	.	A	G	33	4	37	0	3	40	0	0
4	118484072	.	A	G	30	12	42	0	1	43	0	0
4	119080668	.	T	C	20	3	23	0	2	25	0	0
4	124838094	.	A	G	12	12	24	0	0	24	0	0
4	125982944	.	A	G	10	9	19	0	0	19	0	0
4	125982989	.	A	G	13	3	16	0	0	16	0	0
4	125985458	.	A	G	21	4	25	0	0	26	1	0
4	129041803	.	A	G	6	3	9	0	0	9	0	0
4	129062418	.	T	C	2	2	4	0	0	4	0	0
4	129074340	.	T	C	1	4	5	0	0	5	0	0
4	129107038	.	A	G	1	4	5	0	0	5	0	0
4	131679966	.	T	C	41	7	48	0	1	49	0	0
4	131947714	.	C	T	2	2	4	3	0	7	0	0
4	132804542	.	G	A	52	4	56	0	7	63	0	0
4	134289009	.	A	G	1	2	3	0	0	3	0	0
4	137954261	.	A	G	11	3	14	0	0	14	0	0
4	137987341	.	A	G	117	25	142	0	3	145	0	0
4	137987354	.	A	G	88	44	132	0	1	133	0	0
4	140678893	.	A	G	16	4	20	0	0	20	0	0
4	141488012	.	T	C	44	4	48	0	5	53	0	0
4	144314687	.	A	G	9	2	11	32	0	43	0	0
4	147907712	.	T	C	7	2	9	0	0	9	0	0
4	147907715	.	T	C	6	2	8	0	0	8	0	0
4	147907821	.	T	C	8	3	11	0	0	11	0	0
4	148140817	.	A	G	12	4	16	0	0	16	0	0
4	148163513	.	T	C	12	2	14	0	0	14	0	0
4	149203211	.	A	G	32	14	46	0	0	46	0	0
4	149552818	.	T	C	1	3	4	0	0	4	0	0
4	149553915	.	T	C	3	2	5	0	0	5	0	0
4	155706828	.	A	G	26	13	39	1	4	44	0	0
4	155800341	.	A	G	21	6	27	0	0	27	0	0
4	155800382	.	A	G	25	3	28	0	1	29	0	0
4	155800978	.	A	G	16	3	19	0	0	19	0	0
4	156095123	.	A	G	84	82	166	0	1	167	0	0
4	156294001	.	A	G	11	2	13	0	0	13	0	0
4	156294088	.	A	G	3	2	5	0	0	5	0	0
5	3680498	.	T	C	9	5	14	0	0	14	0	0
5	5832991	.	C	G	16	2	18	109	4	131	0	0
5	5833142	.	A	G	3	10	13	12	2	27	0	0
5	9205854	.	A	G	2	2	4	0	0	4	0	0
5	22733550	.	C	T	1	10	11	6	0	17	0	0
5	22930972	.	G	A	1	2	3	14	1	18	0	0
5	23627727	.	T	C	7	2	9	0	0	9	0	0
5	24649635	.	T	C	19	3	22	0	0	22	0	0
5	25430722	.	A	G	11	2	13	0	1	14	0	0
5	25895953	.	T	C	9	2	11	0	0	11	0	0
5	29435627	.	T	C	21	3	24	0	0	24	0	0
5	29658129	.	A	G	1	5	6	0	0	6	0	0
5	31330824	.	T	C	11	4	15	0	0	15	0	0
5	33149755	.	A	G	10	2	12	0	0	12	0	0
5	33151062	.	T	A	11	8	19	0	0	19	0	0
5	33573872	.	A	G	12	3	15	0	0	15	0	0
5	65605388	.	T	C	72	25	97	1	1	99	0	0
5	65605389	.	T	C	56	36	92	1	5	98	0	0
5	72315534	.	A	G	13	4	17	0	1	18	0	0
5	77555578	.	T	C	8	23	31	0	0	31	0	0
5	88790546	.	C	A	2	3	5	0	0	5	0	0
5	91909028	.	A	G	2	2	4	1	0	5	0	0
5	104137641	.	A	G	4	3	7	0	0	7	0	0
5	110081429	.	C	T	8	5	13	0	0	13	0	0
5	110081431	.	C	T	7	2	9	0	3	12	0	0
5	115241332	.	T	C	1	3	4	18	0	22	0	0
5	115686403	.	G	C	2	0	2	0	2	4	0	0
5	117342760	.	A	G	2	2	4	0	0	4	0	0
5	118199940	.	G	A	6	2	8	0	0	8	0	0
5	121581241	.	T	C	4	2	6	0	0	6	0	0
5	121941617	.	A	G	1	3	4	0	0	4	0	0
5	122546790	.	A	G	15	2	17	0	0	17	0	0
5	122943915	.	C	T	4	2	6	0	0	6	0	0
5	123078795	.	T	C	4	2	6	0	0	6	0	0
5	123386729	.	A	G	25	12	37	0	1	38	0	0
5	125534541	.	A	G	52	46	98	2	3	103	0	0
5	129798517	.	A	G	23	6	29	0	0	29	0	0
5	131466314	.	C	T	2	1	3	0	1	4	0	0
5	135192126	.	A	G	13	3	16	0	0	16	0	0
5	135437709	.	T	C	23	17	40	0	0	40	0	0
5	135437715	.	T	C	31	7	38	0	0	38	0	0
5	135665678	.	A	G	4	2	6	0	0	6	0	0
5	135667285	.	T	C	5	2	7	0	0	7	0	0
5	135897091	.	A	G	7	2	9	0	0	9	0	0
5	136941953	.	A	G	96	32	128	1	4	133	0	0
5	138983558	.	A	C	5	3	8	0	0	8	0	0
5	142655047	.	A	G	111	32	143	0	2	146	1	0
5	142856760	.	T	C	25	3	28	0	1	29	0	0
5	142888875	.	G	T	22	6	28	0	2	30	0	0
5	143382050	.	A	G	5	4	9	0	0	9	0	0
5	143382388	.	A	G	5	3	8	0	1	9	0	0
5	143751066	.	A	G	16	3	19	0	0	19	0	0
5	143883169	.	A	G	1	5	6	0	0	6	0	0
5	145126825	.	T	C	1	3	4	0	0	4	0	0
5	148269115	.	G	C	13	16	29	0	1	30	0	0
5	150561734	.	T	C	14	3	17	0	0	17	0	0
6	7872587	.	G	A	1	7	8	0	0	8	0	0
6	8458826	.	T	C	1	4	5	0	0	5	0	0
6	12041543	.	T	A	11	14	25	1	1	27	0	0
6	25689644	.	G	A	41	21	62	0	1	63	0	0
6	31492602	.	A	G	6	8	14	0	6	20	0	0
6	37783131	.	C	T	1	2	3	22	1	26	0	0
6	37847782	.	A	G	18	4	22	0	0	22	0	0
6	39312088	.	T	C	22	6	28	0	1	29	0	0
6	39312096	.	T	C	28	3	31	0	0	31	0	0
6	49233394	.	T	C	25	3	28	0	0	28	0	0
6	57994575	.	C	T	1	3	4	5	3	12	0	0
6	66517065	.	A	G	9	4	13	0	0	13	0	0
6	66517625	.	A	G	7	13	20	0	0	20	0	0
6	66517635	.	A	G	14	4	18	0	0	18	0	0
6	67182821	.	C	T	0	2	2	7	2	11	0	0
6	72584973	.	T	C	8	2	10	0	0	10	0	0
6	81938595	.	G	T	4	2	6	1	1	8	0	0
6	81938596	.	G	T	7	2	9	1	0	10	0	0
6	84789875	.	G	C	1	2	3	0	0	3	0	0
6	84790053	.	T	G	0	3	3	1	1	5	0	0
6	86558654	.	A	C	1	2	3	0	0	3	0	0
6	96010078	.	C	T	2	2	4	0	0	4	0	0
6	118566170	.	T	C	12	3	15	5	1	21	0	0
6	126619121	.	T	C	59	29	88	0	1	89	0	0
6	128338757	.	T	C	2	3	5	0	0	5	0	0
6	134963025	.	A	G	6	2	8	0	0	8	0	0
6	138399546	.	A	G	43	8	51	1	5	57	0	0
7	3463600	.	A	G	115	25	140	0	6	146	0	0
7	4467846	.	T	C	5	2	7	0	0	7	0	0
7	6357880	.	A	G	2	5	7	0	0	7	0	0
7	6357890	.	A	G	2	5	7	0	0	7	0	0
7	6969234	.	A	G	33	6	39	0	0	39	0	0
7	12600489	.	T	C	1	2	3	0	0	3	0	0
7	12707543	.	A	G	4	3	7	0	0	7	0	0
7	12707548	.	A	G	4	3	7	0	0	7	0	0
7	16515475	.	T	A	5	2	7	0	0	7	0	0
7	16571326	.	A	G	1	7	8	0	0	8	0	0
7	16619272	.	A	G	8	40	48	0	0	48	0	0
7	16619714	.	A	G	62	26	88	0	5	93	0	0
7	16829094	.	A	G	1	9	10	0	1	11	0	0
7	18590576	.	G	A	1	5	6	0	0	6	0	0
7	18696483	.	T	C	23	19	42	0	6	48	0	0
7	18699082	.	T	A	2	6	8	0	0	8	0	0
7	18873733	.	T	C	16	4	20	0	0	20	0	0
7	18873753	.	T	C	23	5	28	0	0	28	0	0
7	19086180	.	G	T	2	2	4	0	0	4	0	0
7	19240036	.	T	C	13	2	15	0	0	15	0	0
7	19638449	.	T	A	3	9	12	0	0	12	0	0
7	19638461	.	T	A	7	4	11	0	0	11	0	0
7	23905234	.	G	A	1	1	2	1	0	3	0	0
7	23975294	.	A	G	2	3	5	7	1	13	0	0
7	24901198	.	C	T	1	8	9	0	0	9	0	0
7	26904992	.	A	G	13	2	15	0	0	15	0	0
7	26904993	.	A	G	1	14	15	0	0	15	0	0
7	26905060	.	A	G	11	6	17	0	0	17	0	0
7	27227593	.	T	C	67	9	76	1	1	78	0	0
7	27520956	.	A	G	8	9	17	0	0	17	0	0
7	27583150	.	C	G	1	1	2	0	1	3	0	0
7	27583373	.	G	A	3	1	4	8	1	13	0	0
7	27663471	.	G	A	2	3	5	1	0	6	0	0
7	27663507	.	T	C	5	3	8	0	1	9	0	0
7	27663582	.	A	G	1	4	5	0	0	5	0	0
7	27663968	.	C	T	1	7	8	6	1	15	0	0
7	27674221	.	G	A	1	4	5	7	0	12	0	0
7	28723647	.	T	C	1	5	6	0	1	7	0	0
7	28922504	.	T	C	11	4	15	0	0	15	0	0
7	29533496	.	T	C	1	4	5	0	0	5	0	0
7	29533520	.	A	G	1	3	4	0	0	4	0	0
7	30147085	.	T	G	0	2	2	0	1	3	0	0
7	30170582	.	C	G	2	0	2	0	1	3	0	0
7	30170598	.	T	C	0	3	3	0	0	3	0	0
7	30445266	.	C	G	1	9	10	0	1	11	0	0
7	35090723	.	A	G	7	4	11	0	0	11	0	0
7	35090726	.	A	G	6	3	9	0	0	9	0	0
7	43174884	.	T	C	5	3	8	0	0	8	0	0
7	44974747	.	A	G	14	2	16	48	2	66	0	0
7	45032973	.	T	C	10	13	23	0	0	23	0	0
7	45141114	.	T	C	4	2	6	0	0	6	0	0
7	49206073	.	A	G	1	2	3	0	0	3	0	0
7	73388713	.	T	C	9	2	11	0	0	11	0	0
7	79741424	.	G	T	5	3	8	0	1	9	0	0
7	79741425	.	G	T	6	1	7	0	4	11	0	0
7	81522050	.	A	G	6	2	8	0	0	8	0	0
7	81522943	.	A	G	3	3	6	0	0	6	0	0
7	81533652	.	C	T	36	28	64	0	1	65	0	0
7	82225260	.	T	C	2	2	4	0	0	4	0	0
7	83406399	.	G	A	1	2	3	3	0	6	0	0
7	98969304	.	A	G	30	4	34	0	0	34	0	0
7	103988513	.	T	C	2	3	5	0	0	5	0	0
7	110655309	.	T	C	37	7	44	1	3	48	0	0
7	120104113	.	G	T	1	2	3	3	0	6	0	0
7	123582585	.	A	G	11	3	14	0	1	15	0	0
7	126853494	.	A	G	49	10	59	0	0	59	0	0
7	126853784	.	A	G	62	10	72	0	0	72	0	0
7	127160348	.	G	A	0	2	2	0	5	7	0	0
7	127519115	.	A	G	1	3	4	0	0	4	0	0
7	130360893	.	A	T	7	10	17	0	0	17	0	0
7	140913836	.	T	C	3	2	5	0	4	9	0	0
7	140916604	.	A	G	45	14	59	0	0	59	0	0
7	141014406	.	T	G	5	1	6	0	5	11	0	0
7	142207010	.	T	C	73	20	93	0	1	94	0	0
8	13336085	.	T	C	3	2	5	0	0	5	0	0
8	19741629	.	C	T	6	5	11	7	0	18	0	0
8	20053431	.	C	T	3	1	4	0	1	5	0	0
8	20157964	.	A	G	12	6	18	56	0	74	0	0
8	20584257	.	A	G	7	2	9	0	0	9	0	0
8	20698008	.	A	T	34	5	39	25	0	65	1	0
8	20727130	.	G	A	41	13	54	4	1	59	0	0
8	26305539	.	T	C	12	2	14	0	0	14	0	0
8	26306143	.	T	C	15	3	18	0	0	18	0	0
8	26306187	.	T	C	9	5	14	0	1	15	0	0
8	35125762	.	G	A	2	3	5	0	0	5	0	0
8	35934896	.	A	T	10	1	11	0	0	11	0	0
8	35934898	.	A	C	9	1	10	0	0	10	0	0
8	41370800	.	A	G	15	7	22	0	0	22	0	0
8	42700052	.	A	G	1	4	5	10	0	15	0	0
8	47742106	.	A	G	0	9	9	0	0	9	0	0
8	57960604	.	A	G	1	2	3	0	0	3	0	0
8	69766592	.	A	G	10	5	15	0	0	15	0	0
8	70017218	.	C	G	1	5	6	18	0	24	0	0
8	70017232	.	G	A	1	2	3	12	0	15	0	0
8	70028682	.	T	C	6	2	8	6	0	14	0	0
8	70481589	.	T	C	16	4	20	0	0	20	0	0
8	70710605	.	C	T	3	2	5	0	0	5	0	0
8	72977426	.	A	G	30	28	58	0	0	58	0	0
8	74079692	.	T	C	9	2	11	0	0	11	0	0
8	80698545	.	T	C	5	2	7	0	0	7	0	0
8	80698547	.	G	A	4	2	6	0	0	6	0	0
8	85637794	.	A	G	6	2	8	0	0	8	0	0
8	85781500	.	G	C	3	2	5	0	0	5	0	0
8	94744441	.	A	T	18	2	20	3	11	34	0	0
8	95049423	.	A	G	6	2	8	0	0	8	0	0
8	104987504	.	A	G	1	2	3	0	0	3	0	0
8	109686110	.	A	T	1	0	1	0	4	5	0	0
8	109686111	.	A	T	1	1	2	0	3	5	0	0
8	110817217	.	A	G	41	7	48	0	1	49	0	0
8	111731758	.	T	C	24	4	28	0	0	28	0	0
8	120486932	.	T	C	7	2	9	0	0	9	0	0
8	121823764	.	T	C	6	2	8	0	0	8	0	0
8	122754816	.	T	A	2	2	4	0	0	4	0	0
8	124147389	.	G	A	363	334	697	1	29	727	0	0
8	124261954	.	A	G	4	3	7	0	1	8	0	0
8	125620861	.	T	C	31	13	44	0	0	44	0	0
8	125620868	.	T	C	38	11	49	0	1	50	0	0
8	126865747	.	A	G	8	3	11	0	0	11	0	0
9	3387716	.	A	G	25	4	29	0	0	29	0	0
9	3387771	.	A	G	27	6	33	0	0	33	0	0
9	4456006	.	T	C	2	6	8	0	0	8	0	0
9	7836792	.	T	C	5	2	7	0	0	7	0	0
9	20507083	.	A	G	12	2	14	0	0	14	0	0
9	20512443	.	A	G	5	2	7	0	0	7	0	0
9	20512857	.	A	G	6	2	8	0	0	8	0	0
9	44677385	.	T	C	1	2	3	0	0	3	0	0
9	45747294	.	C	T	2	2	4	1	0	5	0	0
9	55056705	.	A	G	16	5	21	0	1	22	0	0
9	57051592	.	T	C	11	3	14	0	0	14	0	0
9	59513606	.	C	A	10	2	12	0	4	16	0	0
9	59513610	.	G	A	10	1	11	0	4	15	0	0
9	59642055	.	G	A	3	2	5	0	0	5	0	0
9	65253476	.	A	G	5	2	7	0	0	7	0	0
9	72366578	.	T	C	0	4	4	0	1	5	0	0
9	89097389	.	G	A	11	2	13	0	0	13	0	0
9	89097436	.	T	C	8	4	12	1	0	13	0	0
9	95939206	.	A	G	29	3	32	0	3	35	0	0
9	95939293	.	A	G	21	8	29	0	0	29	0	0
9	96777818	.	T	C	3	5	8	297	1	306	0	0
9	103062470	.	C	A	21	3	24	0	1	25	0	0
9	103062472	.	C	A	4	4	8	0	0	8	0	0
9	109659804	.	T	C	8	4	12	1	1	14	0	0
9	119878923	.	C	T	34	24	58	0	2	60	0	0
9	124034058	.	T	G	27	3	30	1	1	32	0	0
X	7774376	.	A	G	4	4	8	0	0	8	0	0
X	40743129	.	A	G	20	154	174	0	1	175	0	0
X	40743165	.	A	G	4	5	9	0	1	10	0	0
X	48588510	.	A	T	11	0	11	0	1	12	0	0
X	55633003	.	T	C	49	9	58	0	1	59	0	0
X	56429832	.	C	A	23	4	27	1	5	33	0	0
X	60223584	.	A	G	2	2	4	0	0	4	0	0
X	60231705	.	A	G	21	18	39	0	0	39	0	0
X	69388256	.	T	C	63	13	76	0	1	77	0	0
X	72913508	.	C	G	29	9	38	0	18	56	0	0
X	73270255	.	T	C	17	6	23	0	0	23	0	0
X	73270256	.	T	C	4	19	23	0	0	23	0	0
X	73270468	.	T	C	4	20	24	0	0	24	0	0
X	73328960	.	A	G	7	2	9	0	0	9	0	0
X	73496154	.	A	T	4	2	6	0	1	7	0	0
X	97987714	.	A	G	4	2	6	0	0	6	0	0
X	102207919	.	A	G	1	3	4	4	0	8	0	0
X	102620158	.	T	C	14	11	25	0	0	25	0	0
X	102620159	.	T	C	11	13	24	0	1	25	0	0
X	102623385	.	T	C	11	2	13	0	3	16	0	0
X	102623421	.	T	C	10	3	13	0	0	13	0	0
X	102625158	.	T	C	10	2	12	0	0	12	0	0
X	106830700	.	T	C	56	10	66	0	1	67	0	0
X	141617410	.	G	T	9	4	13	0	0	13	0	0
X	143170887	.	G	A	10	0	10	0	0	10	0	0
X	145978689	.	A	G	113	16	129	0	2	131	0	0
X	149766871	.	T	C	55	18	73	0	10	83	0	0
X	149767614	.	T	C	114	100	214	3	5	222	0	0
X	159360986	.	A	G	30	4	34	0	1	35	0	0
X	162761028	.	T	C	4	3	7	0	0	7	0	0
X	164972992	.	A	G	11	3	14	5	0	19	0	0
Y	1016394	.	A	G	12	23	35	0	6	41	0	0
Y	1049036	.	A	G	2	2	4	0	0	4	0	0
