contig	position	variantID	refAllele	altAllele	refCount	altCount	totalCount	lowMAPQDepth	lowBaseQDepth	rawDepth	otherBases	improperPairs
1	10101774	.	T	C	3	3	6	0	0	6	0	0
1	22031785	.	T	C	2	7	9	0	0	9	0	0
1	42937769	.	G	A	1	1	2	0	0	2	0	0
1	57982191	.	A	C	2	3	5	0	0	5	0	0
1	59913367	.	A	G	35	11	46	0	2	48	0	0
1	60517747	.	A	G	32	13	45	0	14	59	0	0
1	60525170	.	C	A	16	4	20	0	0	20	0	0
1	64074850	.	A	T	2	1	3	0	6	9	0	0
1	66711873	.	A	G	66	30	96	0	1	97	0	0
1	74631584	.	A	G	1	2	3	0	0	3	0	0
1	75398649	.	A	G	9	6	15	0	0	15	0	0
1	84883650	.	T	C	4	2	6	0	0	6	0	0
1	86203835	.	T	C	2	1	3	0	0	3	0	0
1	86203836	.	G	A	2	1	3	0	0	3	0	0
1	86275689	.	T	C	27	5	32	0	3	35	0	0
1	88187978	.	T	G	1	3	4	0	0	4	0	0
1	88188444	.	G	C	1	2	3	0	0	3	0	0
1	88188745	.	T	A	3	2	5	0	0	5	0	0
1	88189611	.	A	G	3	2	5	0	0	5	0	0
1	88189707	.	C	T	4	4	8	0	0	8	0	0
1	88190921	.	C	T	1	9	10	0	0	10	0	0
1	88191237	.	A	C	14	22	36	0	1	37	0	0
1	88191281	.	A	G	43	9	52	0	1	53	0	0
1	88191320	.	C	T	10	28	38	0	2	40	0	0
1	88191706	.	G	A	18	7	25	0	1	26	0	0
1	88191710	.	T	C	10	14	24	0	0	24	0	0
1	88191744	.	C	A	29	6	35	0	0	35	0	0
1	88191864	.	G	T	36	8	44	1	0	45	0	0
1	88192008	.	C	T	35	6	41	1	3	45	0	0
1	88192048	.	G	C	13	24	37	0	0	37	0	0
1	88192098	.	G	A	31	4	35	0	0	35	0	0
1	88192243	.	A	G	4	24	28	0	0	28	0	0
1	88192700	.	G	A	6	19	25	0	1	26	0	0
1	88192756	.	G	A	8	29	37	0	0	37	0	0
1	88192844	.	G	A	3	18	21	0	0	21	0	0
1	88192980	.	A	G	4	23	27	1	0	28	0	0
1	88193031	.	C	G	8	10	18	1	0	19	0	0
1	88193194	.	C	T	2	3	5	2	0	7	0	0
1	88193568	.	A	C	1	5	6	23	1	30	0	0
1	88193702	.	T	G	2	13	15	33	0	48	0	0
1	88193917	.	G	A	4	16	20	11	0	31	0	0
1	88194314	.	C	A	23	4	27	3	0	30	0	0
1	88197053	.	T	C	0	3	3	0	0	3	0	0
1	88197991	.	A	G	7	32	39	1	0	40	0	0
1	88200452	.	A	G	1	8	9	0	0	9	0	0
1	88200653	.	A	C	1	10	11	0	0	11	0	0
1	88200832	.	C	T	1	8	9	0	1	10	0	0
1	88202772	.	A	T	5	1	6	3	0	9	0	0
1	133065748	.	A	G	37	5	42	0	0	42	0	0
1	135160587	.	A	G	1	3	4	1	0	5	0	0
1	135226637	.	T	C	11	2	13	0	1	14	0	0
1	156255182	.	T	C	1	13	14	0	0	14	0	0
1	156255601	.	T	C	5	5	10	0	1	11	0	0
1	165062020	.	T	G	1	2	3	0	0	3	0	0
1	180924020	.	T	C	15	8	23	0	0	23	0	0
1	183190682	.	A	G	7	4	11	0	1	12	0	0
10	9632715	.	G	A	6	2	8	0	0	8	0	0
10	24474577	.	T	A	1	3	4	0	0	4	0	0
10	24474578	.	G	A	1	3	4	0	0	4	0	0
10	45751670	.	A	G	4	2	6	24	0	30	0	0
10	49118615	.	T	C	7	2	9	0	0	9	0	0
10	49118640	.	T	C	9	3	12	0	0	12	0	0
10	49148885	.	T	C	2	23	25	0	1	26	0	0
10	57383221	.	A	G	1	2	3	0	0	3	0	0
10	57391874	.	C	T	15	5	20	0	0	20	0	0
10	62645542	.	T	C	2	2	4	0	0	4	0	0
10	80522269	.	T	C	3	2	5	0	0	5	0	0
10	81366434	.	G	T	5	3	8	0	0	8	0	0
10	82486401	.	T	C	12	3	15	0	0	15	0	0
10	88049126	.	A	G	1	2	3	0	0	3	0	0
10	93801926	.	T	C	6	3	9	0	0	9	0	0
10	115300325	.	T	C	2	2	4	0	0	4	0	0
10	126903751	.	T	C	45	13	58	0	0	58	0	0
10	128032463	.	A	G	1	4	5	0	0	5	0	0
11	3077575	.	C	A	2	3	5	35	0	40	0	0
11	19671092	.	G	A	2	3	5	3	1	9	0	0
11	20178347	.	T	C	10	2	12	0	0	12	0	0
11	23816459	.	A	C	16	2	18	0	0	18	0	0
11	29495850	.	A	G	4	2	6	5	1	12	0	0
11	30090539	.	A	G	153	143	296	0	6	302	0	0
11	43572939	.	A	G	3	2	5	0	0	5	0	0
11	45821425	.	T	C	10	4	14	0	0	14	0	0
11	46163470	.	T	C	39	245	284	0	3	287	0	0
11	52017633	.	A	G	9	3	12	0	0	12	0	0
11	54730814	.	T	C	14	3	17	0	0	17	0	0
11	62500085	.	A	G	14	1	15	1	0	16	0	0
11	65625566	.	T	C	1	2	3	0	0	3	0	0
11	69922901	.	A	G	4	2	6	0	0	6	0	0
11	75067258	.	T	C	24	5	29	0	0	29	0	0
11	77426880	.	T	C	27	10	37	0	0	37	0	0
11	82853481	.	A	G	1	2	3	0	0	3	0	0
11	86388573	.	A	G	7	2	9	0	1	10	0	0
11	86521633	.	T	C	2	2	4	2	0	6	0	0
11	87014114	.	A	G	10	2	12	0	0	12	0	0
11	87014557	.	A	G	7	2	9	0	0	9	0	0
11	94431300	.	T	C	6	3	9	0	0	9	0	0
11	94431842	.	T	C	11	4	15	0	1	16	0	0
11	97535375	.	T	C	10	2	12	0	0	12	0	0
11	97535690	.	T	C	7	4	11	0	1	12	0	0
11	100488792	.	T	C	12	5	17	0	0	17	0	0
11	101089557	.	T	C	12	4	16	0	0	16	0	0
11	101089802	.	T	C	2	8	10	0	0	10	0	0
11	116471963	.	T	C	11	24	35	0	1	36	0	0
11	119337017	.	C	T	1	3	4	0	0	4	0	0
12	3454168	.	A	G	31	5	36	8	1	45	0	0
12	3454248	.	A	G	12	27	39	6	2	47	0	0
12	17479809	.	A	G	5	19	24	0	0	24	0	0
12	46747117	.	T	C	27	13	40	0	0	40	0	0
12	54719142	.	T	C	33	5	38	0	2	40	0	0
12	65114061	.	T	C	3	2	5	0	0	5	0	0
12	69244102	.	A	G	14	3	17	0	1	18	0	0
12	71041403	.	A	G	2	25	27	0	0	27	0	0
12	71041945	.	A	G	14	4	18	0	1	19	0	0
12	73975614	.	A	G	3	2	5	0	0	5	0	0
12	91605436	.	T	C	8	2	10	0	0	10	0	0
12	98949293	.	C	A	10	3	13	0	3	16	0	0
12	101887890	.	T	C	20	3	23	0	1	24	0	0
12	108993691	.	A	G	10	2	12	0	0	12	0	0
13	3701129	.	G	C	15	6	21	0	1	22	0	0
13	8901801	.	T	C	8	5	13	3	0	16	0	0
13	9144050	.	A	G	8	2	10	0	0	10	0	0
13	9716348	.	C	T	5	3	8	0	2	10	0	0
13	14225628	.	T	C	18	4	22	0	1	23	0	0
13	14226674	.	T	C	30	8	38	0	1	39	0	0
13	17978887	.	T	C	8	2	10	0	0	10	0	0
13	17979133	.	T	C	6	3	9	0	0	9	0	0
13	21574169	.	T	C	11	2	13	0	0	13	0	0
13	21574188	.	T	C	11	2	13	0	0	13	0	0
13	41179544	.	A	G	2	2	4	0	0	4	0	0
13	56886876	.	G	T	9	2	11	0	3	14	0	0
13	63448526	.	A	G	4	2	6	0	1	7	0	0
13	64438124	.	T	C	9	4	13	0	0	13	0	0
13	65214229	.	G	A	9	6	15	0	2	17	0	0
13	107550677	.	C	T	5	1	6	34	1	41	0	0
13	107861323	.	C	T	5	2	7	0	1	8	0	0
13	119625401	.	G	T	6	5	11	0	0	11	0	0
14	10058181	.	A	G	89	24	113	0	0	113	0	0
14	20517408	.	T	C	6	2	8	0	0	8	0	0
14	21846832	.	A	G	8	21	29	0	1	30	0	0
14	21846833	.	A	G	23	7	30	0	0	30	0	0
14	21847779	.	A	G	53	15	68	0	2	70	0	0
14	25979864	.	T	G	1	2	3	0	0	3	0	0
14	26382413	.	T	C	3	2	5	0	0	5	0	0
14	29788070	.	T	C	11	3	14	0	1	15	0	0
14	29788078	.	T	C	14	7	21	0	0	21	0	0
14	32018582	.	A	G	20	7	27	0	2	29	0	0
14	51013458	.	T	C	8	3	11	0	0	11	0	0
14	51109987	.	A	G	3	2	5	0	0	5	0	0
14	75957159	.	T	C	15	4	19	0	0	19	0	0
14	79526507	.	G	A	18	12	30	0	4	34	0	0
14	103584115	.	T	C	13	7	20	0	0	20	0	0
14	118470948	.	C	T	3	2	5	0	2	7	0	0
14	118470950	.	A	T	4	2	6	0	1	7	0	0
14	121273016	.	A	G	10	4	14	0	0	14	0	0
14	123864295	.	C	T	11	6	17	0	0	17	0	0
15	8187674	.	A	G	4	7	11	0	0	11	0	0
15	8188973	.	A	G	4	5	9	0	2	11	0	0
15	33083311	.	T	C	1	1	2	0	1	3	0	0
15	33083314	.	T	A	1	1	2	0	1	3	0	0
15	38969299	.	A	G	2	2	4	0	0	4	0	0
15	50520529	.	C	A	1	2	3	0	1	4	0	0
15	55115868	.	T	C	8	1	9	0	0	9	0	0
15	55115869	.	G	A	8	1	9	0	0	9	0	0
15	58814248	.	C	T	13	4	17	0	0	17	0	0
15	66158075	.	T	C	8	5	13	0	0	13	0	0
15	76316680	.	A	G	4	3	7	0	0	7	0	0
15	79571382	.	G	A	23	5	28	0	3	31	0	0
15	81799307	.	G	A	25	4	29	0	4	33	0	0
15	84837108	.	T	C	10	2	12	0	1	13	0	0
15	98441085	.	C	T	7	1	8	0	1	9	0	0
15	98634993	.	T	C	17	20	37	0	0	37	0	0
15	98731431	.	T	C	24	10	34	0	0	34	0	0
15	99142536	.	T	C	7	1	8	5	0	13	0	0
15	99626091	.	A	G	3	4	7	0	0	7	0	0
16	4444240	.	T	C	6	3	9	0	1	10	0	0
16	13520445	.	A	G	13	10	23	0	0	23	0	0
16	13520501	.	A	G	11	3	14	0	0	14	0	0
16	13651947	.	T	C	21	6	27	0	0	27	0	0
16	16866848	.	A	G	1	2	3	0	0	3	0	0
16	17321752	.	A	G	7	3	10	0	0	10	0	0
16	18653678	.	A	G	35	15	50	0	1	51	0	0
16	19942498	.	A	G	33	22	55	0	1	56	0	0
16	20363104	.	A	G	2	4	6	0	0	6	0	0
16	20363121	.	A	G	3	3	6	0	0	6	0	0
16	20363153	.	A	G	4	4	8	0	0	8	0	0
16	30330773	.	T	C	7	3	10	0	0	10	0	0
16	32119150	.	A	G	17	9	26	0	0	26	0	0
16	52026501	.	G	T	5	2	7	0	0	7	0	0
16	52273410	.	C	T	10	2	12	0	0	12	0	0
16	87230813	.	T	C	7	4	11	0	0	11	0	0
16	87230814	.	T	C	8	3	11	0	0	11	0	0
16	87299347	.	A	G	3	2	5	0	0	5	0	0
16	87737431	.	T	C	0	1	1	0	0	1	0	0
16	91453021	.	A	G	50	14	64	0	0	64	0	0
17	11286022	.	T	C	1	1	2	0	0	2	0	0
17	15741073	.	A	G	1	5	6	0	0	6	0	0
17	18050496	.	A	G	1	3	4	0	0	4	0	0
17	23984719	.	T	A	7	2	9	0	0	9	0	0
17	32280157	.	A	G	3	2	5	0	1	6	0	0
17	33966501	.	T	C	20	4	24	99	2	125	0	0
17	34147531	.	A	G	7	7	14	0	0	14	0	0
17	36580955	.	T	C	7	3	10	0	0	10	0	0
17	40158498	.	T	C	2952	3838	6790	0	156	7251	305	0
17	40159543	.	T	C	30	222	252	0	3	255	0	0
17	45973875	.	T	C	11	58	69	0	0	69	0	0
17	46472812	.	G	A	4	2	6	0	0	6	0	0
17	57570296	.	T	A	1	1	2	0	0	2	0	0
17	57570298	.	T	G	1	1	2	0	0	2	0	0
17	95067479	.	T	C	19	14	33	0	0	33	0	0
18	6792650	.	A	G	22	3	25	0	1	26	0	0
18	24097917	.	A	G	4	3	7	0	0	7	0	0
18	24639048	.	T	C	9	2	11	0	0	11	0	0
18	24639050	.	T	C	6	3	9	0	0	9	0	0
18	32561134	.	A	G	33	4	37	0	0	37	0	0
18	34998034	.	G	A	1	3	4	0	0	4	0	0
18	35807586	.	T	C	44	7	51	0	1	52	0	0
19	3940126	.	A	G	1	3	4	0	0	4	0	0
19	4813117	.	T	C	5	4	9	0	0	9	0	0
19	4813159	.	T	C	5	2	7	0	0	7	0	0
19	5503302	.	T	C	3	2	5	0	0	5	0	0
19	6405499	.	G	T	3	2	5	0	0	5	0	0
19	6895771	.	T	C	5	2	7	0	0	7	0	0
19	6895783	.	T	C	4	4	8	0	0	8	0	0
19	7515480	.	A	G	18	8	26	0	0	26	0	0
19	10223060	.	T	C	19	34	53	0	2	55	0	0
19	10566002	.	A	G	5	2	7	0	0	7	0	0
19	12441626	.	A	G	20	6	26	0	1	27	0	0
19	16255969	.	C	A	1	2	3	0	0	3	0	0
19	34571000	.	A	G	3	2	5	0	0	5	0	0
19	43429601	.	A	G	11	11	22	0	1	23	0	0
19	43429753	.	A	G	21	3	24	0	0	24	0	0
19	44993669	.	T	C	28	8	36	0	1	37	0	0
2	26278313	.	A	G	2	2	4	0	0	4	0	0
2	29664907	.	T	C	4	2	6	0	0	6	0	0
2	29666798	.	T	C	19	4	23	0	1	24	0	0
2	31937444	.	A	G	6	2	8	0	1	9	0	0
2	32196762	.	A	G	51	7	58	0	0	58	0	0
2	73605562	.	G	C	1	1	2	0	0	2	0	0
2	91043632	.	A	G	31	5	36	1	0	37	0	0
2	91551819	.	A	G	1	2	3	0	0	3	0	0
2	104511430	.	T	C	10	2	12	0	0	12	0	0
2	120451649	.	A	G	11	6	17	2	0	19	0	0
2	121015462	.	A	G	4	2	6	0	0	6	0	0
2	121323384	.	T	C	10	3	13	0	0	13	0	0
2	127126729	.	A	G	1	3	4	0	0	4	0	0
2	127127066	.	A	G	5	2	7	0	0	7	0	0
2	132151800	.	A	G	47	227	274	0	0	274	0	0
2	144382358	.	A	G	10	3	13	0	1	14	0	0
2	152114942	.	A	G	1	4	5	0	0	5	0	0
2	152579289	.	G	A	0	2	2	0	1	3	0	0
2	153108492	.	A	G	5	4	9	0	0	9	0	0
2	153459246	.	T	C	2	3	5	0	1	6	0	0
2	154379850	.	A	G	25	8	33	0	0	33	0	0
2	157400030	.	T	C	60	12	72	9	1	82	0	0
2	158202902	.	A	G	8	3	11	0	0	11	0	0
2	158225545	.	A	G	295	50	345	1	1	347	0	0
2	158226873	.	A	G	95	309	404	1	10	416	1	0
2	158438124	.	T	C	3	2	5	0	0	5	0	0
2	163309459	.	T	C	2	10	12	0	1	13	0	0
2	163563223	.	T	A	3	2	5	0	0	5	0	0
2	164635687	.	T	C	2	5	7	0	0	7	0	0
2	164953669	.	T	C	27	7	34	0	1	35	0	0
2	164953773	.	T	C	19	4	23	0	0	23	0	0
2	168055230	.	T	C	2	2	4	0	0	4	0	0
2	169913421	.	A	G	6	2	8	0	0	8	0	0
2	174169694	.	A	G	61	12	73	1	2	76	0	0
2	174486770	.	A	G	10	2	12	0	0	12	0	0
2	174486771	.	C	T	10	2	12	0	0	12	0	0
2	181159604	.	A	G	3	2	5	0	0	5	0	0
3	26385911	.	T	C	8	3	11	0	0	11	0	0
3	32636549	.	T	C	6	5	11	0	0	11	0	0
3	40748697	.	A	G	29	6	35	11	0	46	0	0
3	57551795	.	T	C	4	2	6	0	0	6	0	0
3	57551841	.	T	C	2	2	4	0	0	4	0	0
3	65587492	.	A	G	1	2	3	0	0	3	0	0
3	80599593	.	T	C	29	46	75	0	1	76	0	0
3	80614159	.	T	C	8	11	19	0	0	19	0	0
3	80614215	.	T	C	70	45	115	0	0	115	0	0
3	88259542	.	A	G	10	2	12	0	1	13	0	0
3	88445178	.	G	T	5	2	7	0	1	8	0	0
3	88544571	.	A	G	3	2	5	0	0	5	0	0
3	89090052	.	G	A	9	4	13	0	1	14	0	0
3	89152086	.	C	T	1	2	3	0	0	3	0	0
3	94323864	.	A	G	1	2	3	0	0	3	0	0
3	94921221	.	T	G	1	0	1	0	3	4	0	0
3	95091616	.	T	C	5	3	8	0	0	8	0	0
3	96540029	.	A	G	18	6	24	0	3	27	0	0
3	102973406	.	A	G	30	5	35	0	0	35	0	0
3	104834685	.	A	G	1	4	5	0	0	5	0	0
3	104835351	.	A	G	2	2	4	0	0	4	0	0
3	122649821	.	A	G	6	2	8	0	0	8	0	0
3	135112631	.	T	C	37	6	43	0	1	44	0	0
3	135139298	.	A	G	2	2	4	0	0	4	0	0
3	138611942	.	A	T	2	2	4	0	0	4	0	0
3	143894308	.	C	T	6	3	9	0	0	9	0	0
4	21911945	.	A	G	6	2	8	0	0	8	0	0
4	32022582	.	A	G	25	7	32	0	2	34	0	0
4	33019420	.	A	G	59	29	88	0	4	92	0	0
4	33020417	.	A	G	51	38	89	0	0	89	0	0
4	33924873	.	A	G	22	4	26	0	0	26	0	0
4	41518514	.	T	C	138	25	163	0	2	165	0	0
4	42989008	.	T	C	1	2	3	0	0	3	0	0
4	62342224	.	A	G	12	2	14	0	0	14	0	0
4	69844043	.	C	T	1	2	3	9	0	12	0	0
4	73416492	.	A	T	0	2	2	0	1	3	0	0
4	73416500	.	C	T	2	1	3	0	0	3	0	0
4	86495344	.	G	T	62	13	75	0	1	76	0	0
4	103021909	.	A	G	13	2	15	0	3	18	0	0
4	108198034	.	A	T	7	1	8	0	1	9	0	0
4	108198313	.	A	G	5	7	12	0	0	12	0	0
4	108493720	.	T	C	4	2	6	0	0	6	0	0
4	116410052	.	T	C	12	2	14	0	1	15	0	0
4	116410105	.	T	C	7	2	9	0	1	10	0	0
4	118484005	.	A	G	5	26	31	0	0	31	0	0
4	118484020	.	A	G	26	3	29	0	1	30	0	0
4	118484072	.	A	G	14	4	18	0	0	18	0	0
4	119080668	.	T	C	10	2	12	0	1	13	0	0
4	120741571	.	A	G	2	1	3	0	1	4	0	0
4	124838094	.	A	G	6	7	13	0	0	13	0	0
4	125982944	.	A	G	6	9	15	0	0	15	0	0
4	125982989	.	A	G	6	4	10	0	0	10	0	0
4	131679966	.	T	C	22	3	25	0	0	25	0	0
4	132804542	.	G	A	10	4	14	1	4	19	0	0
4	133836902	.	A	G	5	2	7	0	0	7	0	0
4	135483574	.	C	T	0	2	2	0	1	3	0	0
4	137987341	.	A	G	48	17	65	0	1	66	0	0
4	137987354	.	A	G	43	19	62	0	2	64	0	0
4	140678829	.	A	G	12	4	16	0	0	16	0	0
4	140678893	.	A	G	9	3	12	0	0	12	0	0
4	149203211	.	A	G	11	10	21	0	0	21	0	0
4	155706828	.	A	G	10	2	12	0	2	14	0	0
4	155800977	.	A	G	6	4	10	0	0	10	0	0
4	155800978	.	A	G	6	4	10	0	0	10	0	0
4	156095123	.	A	G	43	46	89	0	0	89	0	0
5	5833142	.	A	G	1	2	3	6	0	9	0	0
5	24649635	.	T	C	16	3	19	1	0	20	0	0
5	25430722	.	A	G	5	2	7	0	0	7	0	0
5	31230241	.	T	C	5	2	7	0	0	7	0	0
5	31330824	.	T	C	11	3	14	0	0	14	0	0
5	65605388	.	T	C	25	10	35	0	0	35	0	0
5	65605389	.	T	C	20	13	33	0	1	34	0	0
5	77555578	.	T	C	3	11	14	0	0	14	0	0
5	77555630	.	T	C	2	13	15	0	2	17	0	0
5	110413206	.	T	C	1	2	3	0	0	3	0	0
5	111602776	.	C	T	12	3	15	0	6	21	0	0
5	113058357	.	A	G	6	2	8	0	0	8	0	0
5	114866851	.	T	C	4	2	6	0	1	7	0	0
5	115435667	.	T	C	11	2	13	0	1	14	0	0
5	115437319	.	T	C	2	3	5	0	0	5	0	0
5	122872763	.	T	C	14	2	16	0	1	18	1	0
5	123386729	.	A	G	9	9	18	0	1	19	0	0
5	124792968	.	A	G	4	2	6	0	0	6	0	0
5	125534541	.	A	G	32	28	60	1	4	65	0	0
5	129798517	.	A	G	9	3	12	0	1	13	0	0
5	132570854	.	T	A	2	2	4	0	1	5	0	0
5	134653099	.	A	G	1	2	3	0	0	3	0	0
5	135193044	.	A	G	6	2	8	0	0	8	0	0
5	135437709	.	T	C	10	5	15	0	1	16	0	0
5	136941953	.	A	G	67	11	78	0	4	82	0	0
5	138264917	.	A	G	2	2	4	0	0	4	0	0
5	142655047	.	A	G	55	23	78	0	3	81	0	0
5	142856760	.	T	C	11	3	14	0	0	14	0	0
5	142873223	.	T	C	1	2	3	0	0	3	0	0
5	142888875	.	G	T	18	8	26	0	2	28	0	0
5	143751066	.	A	G	16	4	20	0	0	20	0	0
5	150564018	.	T	C	12	2	14	0	0	14	0	0
5	150564021	.	T	C	11	3	14	0	0	14	0	0
6	4760320	.	A	C	3	1	4	0	3	7	0	0
6	15800853	.	G	T	1	1	2	0	0	2	0	0
6	31492602	.	A	G	7	4	11	0	1	12	0	0
6	35222220	.	T	C	8	8	16	0	0	16	0	0
6	37783131	.	C	T	1	1	2	7	2	11	0	0
6	37847782	.	A	G	5	2	7	0	0	7	0	0
6	38265975	.	T	C	7	2	9	0	0	9	0	0
6	39312088	.	T	C	14	4	18	0	0	18	0	0
6	47848942	.	A	G	13	3	16	0	2	18	0	0
6	47849279	.	A	G	7	2	9	0	0	9	0	0
6	66517065	.	A	G	2	3	5	0	0	5	0	0
6	66517625	.	A	G	5	7	12	0	1	13	0	0
6	71791046	.	T	C	6	2	8	0	0	8	0	0
6	72584973	.	T	C	3	2	5	0	0	5	0	0
6	87791783	.	T	C	9	3	12	0	1	13	0	0
6	113588107	.	A	G	3	2	5	0	0	5	0	0
6	120868712	.	A	G	10	2	12	0	1	13	0	0
6	122716274	.	T	C	1	2	3	0	0	3	0	0
6	126619121	.	T	C	49	25	74	0	1	75	0	0
7	3463600	.	A	G	65	10	75	0	1	76	0	0
7	12706157	.	A	G	7	2	9	0	0	9	0	0
7	16605663	.	T	C	5	2	7	0	0	7	0	0
7	16619272	.	A	G	3	35	38	0	0	38	0	0
7	16619714	.	A	G	55	8	63	0	0	63	0	0
7	18869505	.	C	T	1	10	11	0	0	11	0	0
7	19129508	.	C	T	1	5	6	0	0	6	0	0
7	19240036	.	T	C	9	2	11	0	0	11	0	0
7	19483362	.	G	A	1	6	7	0	0	7	0	0
7	23840662	.	G	A	1	6	7	5	0	12	0	0
7	24900888	.	T	C	1	4	5	0	0	5	0	0
7	26904992	.	A	G	6	2	8	0	1	9	0	0
7	26904993	.	A	G	1	6	7	0	1	8	0	0
7	26905060	.	A	G	2	3	5	0	0	5	0	0
7	27227593	.	T	C	52	8	60	0	0	60	0	0
7	27520956	.	A	G	3	3	6	0	0	6	0	0
7	28922504	.	T	C	5	2	7	0	0	7	0	0
7	28922523	.	T	C	4	3	7	0	0	7	0	0
7	45031339	.	T	G	19	5	24	0	4	28	0	0
7	45032973	.	T	C	7	3	10	0	0	10	0	0
7	49206073	.	A	G	2	3	5	0	0	5	0	0
7	49206120	.	A	G	1	4	5	0	0	5	0	0
7	59041183	.	G	T	1	2	3	2	0	5	0	0
7	81253540	.	T	C	10	5	15	0	1	16	0	0
7	81521958	.	A	G	3	3	6	0	0	6	0	0
7	90119236	.	T	C	2	2	4	0	0	4	0	0
7	98969304	.	A	G	10	3	13	0	0	13	0	0
7	109720817	.	C	G	2	2	4	0	0	4	0	0
7	121306558	.	T	C	9	2	11	0	0	11	0	0
7	123582103	.	A	G	35	5	40	0	0	40	0	0
7	126853494	.	A	G	18	7	25	0	1	26	0	0
7	126853784	.	A	G	36	8	44	0	1	45	0	0
7	127165579	.	A	G	1	4	5	0	0	5	0	0
7	127165834	.	A	G	1	2	3	0	0	3	0	0
7	130360893	.	A	T	2	6	8	0	0	8	0	0
7	130995142	.	G	T	4	2	6	0	0	6	0	0
7	139715640	.	A	G	1	4	5	0	0	5	0	0
7	139716520	.	A	G	2	3	5	0	0	5	0	0
7	140440060	.	A	C	2	1	3	0	2	5	0	0
7	140440066	.	A	C	1	3	4	0	0	4	0	0
7	140916604	.	A	G	29	3	32	0	0	32	0	0
7	141014406	.	T	G	4	2	6	0	2	8	0	0
7	142207010	.	T	C	25	17	42	0	0	42	0	0
8	13336085	.	T	C	1	2	3	0	0	3	0	0
8	19741629	.	C	T	3	3	6	4	0	10	0	0
8	20030855	.	G	A	13	3	16	7	0	23	0	0
8	20717395	.	T	A	3	2	5	16	0	21	0	0
8	20727130	.	G	A	22	6	28	3	0	31	0	0
8	67133184	.	G	A	7	2	9	0	0	9	0	0
8	69766592	.	A	G	9	3	12	0	0	12	0	0
8	72106113	.	C	G	73	41	114	0	4	119	1	0
8	72977426	.	A	G	14	19	33	0	0	33	0	0
8	74079692	.	T	C	9	2	11	0	0	11	0	0
8	80065215	.	C	A	1	3	4	0	0	4	0	0
8	84977744	.	T	C	5	2	7	0	0	7	0	0
8	84977909	.	T	C	7	2	9	0	0	9	0	0
8	94744483	.	T	C	3	2	5	0	0	5	0	0
8	107610641	.	C	T	3	2	5	0	0	5	0	0
8	110817217	.	A	G	16	4	20	0	0	20	0	0
8	111731758	.	T	C	18	4	22	0	0	22	0	0
8	114371800	.	T	C	2	1	3	0	1	5	1	0
8	123198434	.	T	C	4	3	7	0	0	7	0	0
8	124261954	.	A	G	5	3	8	0	0	8	0	0
8	125620546	.	T	C	12	2	14	0	0	14	0	0
8	125620861	.	T	C	15	14	29	0	0	29	0	0
8	125620868	.	T	C	27	5	32	0	0	32	0	0
9	3387716	.	A	G	12	2	14	0	0	14	0	0
9	3387771	.	A	G	12	3	15	0	1	16	0	0
9	4313759	.	A	G	2	3	5	0	0	5	0	0
9	4456006	.	T	C	0	2	2	0	0	2	0	0
9	8022080	.	T	C	2	4	6	0	0	6	0	0
9	16288789	.	C	T	11	12	23	0	0	23	0	0
9	20781697	.	A	G	22	3	25	0	0	25	0	0
9	44322503	.	T	C	2	2	4	0	0	4	0	0
9	47764621	.	G	A	12	2	14	0	5	19	0	0
9	58558540	.	G	T	3	5	8	0	1	9	0	0
9	65253476	.	A	G	6	4	10	0	0	10	0	0
9	65595677	.	A	G	3	1	4	0	0	4	0	0
9	66683299	.	C	T	11	3	14	0	1	15	0	0
9	67127254	.	T	C	23	3	26	0	1	27	0	0
9	70333871	.	C	A	13	4	17	0	0	17	0	0
9	72595157	.	A	G	2	2	4	0	0	4	0	0
9	75130967	.	G	A	1	3	4	0	0	4	0	0
9	95939286	.	A	G	19	4	23	0	0	23	0	0
9	95939293	.	A	G	19	7	26	0	2	28	0	0
9	103062470	.	C	A	12	2	14	0	1	15	0	0
9	103062472	.	C	A	5	2	7	0	0	7	0	0
9	106570501	.	C	G	5	1	6	0	0	6	0	0
9	106570502	.	T	C	5	1	6	0	0	6	0	0
9	108409080	.	A	G	2	2	4	0	0	4	0	0
9	124034058	.	T	G	19	6	25	1	0	26	0	0
X	40743129	.	A	G	12	88	100	1	0	101	0	0
X	40743165	.	A	G	3	4	7	0	0	7	0	0
X	55633003	.	T	C	24	4	28	0	0	28	0	0
X	60231705	.	A	G	10	7	17	0	0	17	0	0
X	69388256	.	T	C	31	4	35	0	1	36	0	0
X	73270255	.	T	C	6	5	11	0	0	11	0	0
X	73270256	.	T	C	2	9	11	0	0	11	0	0
X	73270468	.	T	C	2	8	10	0	0	10	0	0
X	101135506	.	G	T	2	2	4	0	0	4	0	0
X	102620158	.	T	C	3	3	6	0	0	6	0	0
X	102620159	.	T	C	1	5	6	0	0	6	0	0
X	102623385	.	T	C	10	3	13	0	5	18	0	0
X	102631489	.	T	C	5	2	7	0	0	7	0	0
X	106830700	.	T	C	38	9	47	0	3	50	0	0
X	141617410	.	G	T	7	2	9	0	0	9	0	0
X	145978689	.	A	G	24	6	30	0	1	31	0	0
X	149766871	.	T	C	36	8	44	0	5	49	0	0
X	149767614	.	T	C	46	33	79	0	5	84	0	0
X	159360986	.	A	G	20	5	25	0	0	25	0	0
X	162761028	.	T	C	4	2	6	0	0	6	0	0
X	164972992	.	A	G	6	2	8	1	0	9	0	0
X	166906187	.	T	C	7	3	10	0	1	11	0	0
Y	1016394	.	A	G	4	11	15	0	1	16	0	0
