contig	position	variantID	refAllele	altAllele	refCount	altCount	totalCount	lowMAPQDepth	lowBaseQDepth	rawDepth	otherBases	improperPairs
1	13696043	.	T	C	8	2	10	2	0	12	0	0
1	22031785	.	T	C	5	2	7	0	0	7	0	0
1	36405381	.	T	C	1	2	3	0	0	3	0	0
1	36478995	.	T	C	4	2	6	0	0	6	0	0
1	36567288	.	G	A	3	2	5	0	0	5	0	0
1	51507771	.	T	C	1	3	4	0	0	4	0	0
1	57982191	.	A	C	13	7	20	0	0	20	0	0
1	59756998	.	A	G	9	4	13	0	0	13	0	0
1	59913367	.	A	G	44	11	55	0	0	55	0	0
1	60517747	.	A	G	29	17	46	0	10	56	0	0
1	63156443	.	A	G	1	3	4	0	0	4	0	0
1	63156735	.	A	G	4	2	6	0	0	6	0	0
1	63634903	.	C	T	10	3	13	0	0	13	0	0
1	66711873	.	A	G	66	21	87	0	6	93	0	0
1	75398649	.	A	G	17	2	19	0	0	19	0	0
1	75398708	.	A	G	2	24	26	0	1	27	0	0
1	86275689	.	T	C	25	5	30	0	3	33	0	0
1	86276528	.	T	C	13	4	17	0	0	17	0	0
1	88187259	.	T	C	3	2	5	0	0	5	0	0
1	88188255	.	C	T	4	2	6	0	0	6	0	0
1	88188745	.	T	A	1	2	3	0	0	3	0	0
1	88189360	.	G	A	3	2	5	0	0	5	0	0
1	88189435	.	G	C	1	3	4	0	0	4	0	0
1	88189462	.	G	A	5	2	7	0	0	7	0	0
1	88189611	.	A	G	7	2	9	0	0	9	0	0
1	88190661	.	G	C	3	3	6	0	0	6	0	0
1	88190679	.	A	G	6	2	8	0	0	8	0	0
1	88190717	.	G	C	3	2	5	0	0	5	0	0
1	88191237	.	A	C	10	28	38	0	4	42	0	0
1	88191281	.	A	G	43	7	50	0	1	51	0	0
1	88191320	.	C	T	9	21	30	0	0	30	0	0
1	88191468	.	C	G	4	32	36	0	0	36	0	0
1	88191706	.	G	A	25	4	29	0	2	31	0	0
1	88191710	.	T	C	9	20	29	0	2	31	0	0
1	88191744	.	C	A	17	1	18	0	1	19	0	0
1	88191864	.	G	T	36	8	44	0	0	44	0	0
1	88192008	.	C	T	44	5	49	0	3	52	0	0
1	88192048	.	G	C	9	29	38	0	2	40	0	0
1	88192098	.	G	A	42	5	47	0	0	47	0	0
1	88192180	.	G	T	59	7	66	0	2	68	0	0
1	88192184	.	T	A	61	7	68	0	1	69	0	0
1	88192243	.	A	G	7	44	51	0	1	52	0	0
1	88192700	.	G	A	10	20	30	0	2	32	0	0
1	88192756	.	G	A	6	27	33	0	2	35	0	0
1	88192980	.	A	G	3	25	28	1	1	30	0	0
1	88193031	.	C	G	14	16	30	0	0	30	0	0
1	88193194	.	C	T	2	2	4	3	1	8	0	0
1	88193568	.	A	C	2	4	6	34	0	40	0	0
1	88193702	.	T	G	1	10	11	26	0	37	0	0
1	88193917	.	G	A	11	13	24	19	0	43	0	0
1	88194314	.	C	A	30	10	40	2	0	42	0	0
1	88197053	.	T	C	16	18	34	0	0	34	0	0
1	88197991	.	A	G	6	25	31	0	1	32	0	0
1	88200832	.	C	T	4	5	9	0	0	9	0	0
1	88205286	.	A	T	9	2	11	3	0	14	0	0
1	93299890	.	A	G	11	4	15	1	0	16	0	0
1	97634781	.	G	A	8	2	10	0	0	10	0	0
1	132927365	.	T	C	5	3	8	0	1	9	0	0
1	133065748	.	A	G	30	6	36	0	1	37	0	0
1	133225995	.	A	G	6	2	8	0	1	9	0	0
1	156255182	.	T	C	5	12	17	0	0	17	0	0
1	156255601	.	T	C	7	2	9	0	0	9	0	0
1	160839934	.	T	C	3	2	5	0	0	5	0	0
1	171151897	.	T	C	1	2	3	0	0	3	0	0
1	180924020	.	T	C	21	7	28	0	0	28	0	0
1	183105229	.	A	G	10	2	12	0	1	13	0	0
1	183105230	.	A	G	11	2	13	0	0	13	0	0
1	183190594	.	A	G	13	7	20	0	0	20	0	0
1	183190595	.	A	G	18	2	20	0	0	20	0	0
1	183190682	.	A	G	14	5	19	0	0	19	0	0
10	20194248	.	A	G	4	3	7	0	0	7	0	0
10	23703059	.	C	T	11	3	14	0	1	15	0	0
10	33791335	.	A	G	1	3	4	0	0	4	0	0
10	49118557	.	T	C	2	8	10	0	0	10	0	0
10	49118584	.	T	C	7	2	9	0	0	9	0	0
10	49118640	.	T	C	12	2	14	0	0	14	0	0
10	57383221	.	A	G	1	3	4	0	0	4	0	0
10	57391874	.	C	T	12	7	19	0	3	22	0	0
10	67931716	.	C	A	11	3	14	0	2	16	0	0
10	70380836	.	G	A	4	1	5	0	1	6	0	0
10	74286083	.	C	T	8	2	10	0	0	10	0	0
10	79702955	.	G	C	3	2	5	0	0	5	0	0
10	79790300	.	C	T	1	1	2	0	1	3	0	0
10	81181979	.	T	C	7	2	9	0	0	9	0	0
10	81182083	.	T	C	14	6	20	0	0	20	0	0
10	81366434	.	G	T	2	3	5	0	3	8	0	0
10	93801873	.	T	C	13	3	16	0	0	16	0	0
10	93801926	.	T	C	6	5	11	0	1	12	0	0
10	94057224	.	A	G	16	4	20	0	0	20	0	0
10	95326880	.	T	C	2	2	4	0	0	4	0	0
10	126858300	.	C	A	3	2	5	0	2	7	0	0
10	126881505	.	T	G	5	1	6	0	1	7	0	0
10	126903751	.	T	C	67	10	77	0	1	78	0	0
10	128032463	.	A	G	3	2	5	0	0	5	0	0
10	128032764	.	A	G	4	2	6	0	0	6	0	0
10	128505929	.	T	C	6	2	8	0	0	8	0	0
11	3077575	.	C	A	6	3	9	52	1	62	0	0
11	4091399	.	T	C	17	4	21	0	2	23	0	0
11	4091432	.	T	C	24	4	28	0	0	28	0	0
11	20178606	.	T	C	14	4	18	0	0	18	0	0
11	23217975	.	C	T	2	3	5	0	0	5	0	0
11	30051812	.	T	C	9	2	11	0	1	12	0	0
11	43572939	.	A	G	3	5	8	0	0	8	0	0
11	43573028	.	A	G	3	4	7	0	0	7	0	0
11	45821425	.	T	C	9	2	11	0	0	11	0	0
11	46163470	.	T	C	64	290	354	1	4	359	0	0
11	49564249	.	C	A	10	5	15	0	0	15	0	0
11	54730814	.	T	C	17	3	20	0	0	20	0	0
11	59401821	.	A	G	16	2	18	0	0	18	0	0
11	60749148	.	A	G	2	2	4	0	0	4	0	0
11	62032236	.	A	G	3	2	5	0	0	5	0	0
11	62032250	.	A	G	4	3	7	0	0	7	0	0
11	69674128	.	A	G	18	4	22	0	0	22	0	0
11	69922901	.	A	G	10	10	20	0	0	20	0	0
11	69924767	.	A	G	13	3	16	0	1	17	0	0
11	69925276	.	A	G	10	4	14	1	0	15	0	0
11	69927869	.	A	G	3	7	10	0	1	11	0	0
11	69937304	.	A	G	8	3	11	0	0	12	1	0
11	72570391	.	A	G	8	2	10	0	0	10	0	0
11	72570452	.	A	G	4	4	8	0	1	9	0	0
11	72687147	.	A	G	9	2	11	0	1	12	0	0
11	74747553	.	T	C	3	3	6	0	1	7	0	0
11	75067258	.	T	C	19	8	27	0	1	28	0	0
11	77426880	.	T	C	39	6	45	0	0	45	0	0
11	78432329	.	C	A	8	1	9	0	3	12	0	0
11	86830735	.	C	A	10	10	20	0	0	20	0	0
11	94431842	.	T	C	8	2	10	0	0	10	0	0
11	96599507	.	C	T	2	1	3	0	0	3	0	0
11	97535375	.	T	C	8	3	11	0	0	11	0	0
11	97535690	.	T	C	8	4	12	0	0	12	0	0
11	98168819	.	A	G	9	2	11	0	0	11	0	0
11	98736061	.	A	G	5	2	7	0	0	7	0	0
11	100329322	.	T	C	7	2	9	0	0	9	0	0
11	100488792	.	T	C	12	6	18	0	1	19	0	0
11	101089557	.	T	C	13	4	17	0	1	18	0	0
11	101089802	.	T	C	8	2	10	0	1	11	0	0
11	101467457	.	A	G	2	2	4	0	0	4	0	0
11	110110435	.	G	A	4	2	6	0	0	6	0	0
11	116303813	.	T	C	6	2	8	0	0	8	0	0
11	116471963	.	T	C	16	17	33	0	1	34	0	0
11	120862124	.	T	C	3	2	5	0	0	5	0	0
12	3454168	.	A	G	27	5	32	14	0	46	0	0
12	3454248	.	A	G	19	32	51	16	1	68	0	0
12	17479809	.	A	G	8	7	15	0	0	15	0	0
12	46747117	.	T	C	21	9	30	0	0	30	0	0
12	54718540	.	T	C	20	5	25	0	0	25	0	0
12	69244102	.	A	G	20	5	25	0	0	25	0	0
12	71041403	.	A	G	6	24	30	0	0	30	0	0
12	71041945	.	A	G	23	5	28	0	0	28	0	0
12	75677928	.	A	G	2	3	5	0	1	6	0	0
12	79128920	.	T	C	7	2	9	0	1	10	0	0
12	84969484	.	T	C	7	2	9	0	0	9	0	0
12	85159286	.	A	G	1	2	3	0	0	3	0	0
12	85159379	.	A	G	2	2	4	0	1	5	0	0
12	101886131	.	T	C	19	6	25	0	0	25	0	0
12	101887890	.	T	C	20	6	26	0	1	27	0	0
12	105784145	.	A	G	2	2	4	0	0	4	0	0
12	109511197	.	C	A	34	3	37	0	29	66	0	0
12	109689209	.	A	G	2	2	4	0	0	4	0	0
13	8901801	.	T	C	11	4	15	1	0	16	0	0
13	9716348	.	C	T	11	2	13	0	0	13	0	0
13	14226674	.	T	C	33	9	42	0	0	42	0	0
13	14228102	.	T	C	21	4	25	0	2	27	0	0
13	15989053	.	T	C	1	3	4	0	0	4	0	0
13	21574169	.	T	C	5	5	10	0	0	10	0	0
13	21574225	.	T	C	5	2	7	0	1	8	0	0
13	30997931	.	A	G	4	2	6	0	0	6	0	0
13	49685058	.	A	G	4	3	7	0	0	7	0	0
13	49685064	.	A	G	5	2	7	0	0	7	0	0
13	55745486	.	G	A	4	5	9	0	4	13	0	0
13	59757011	.	A	G	1	3	4	0	0	4	0	0
13	64438124	.	T	C	11	3	14	0	0	14	0	0
13	65214229	.	G	A	6	5	11	0	2	13	0	0
13	98977362	.	C	A	22	1	23	0	3	26	0	0
13	107862362	.	G	T	7	0	7	0	5	12	0	0
13	119625401	.	G	T	15	14	29	0	0	29	0	0
14	9647289	.	A	G	41	6	47	0	1	48	0	0
14	10058181	.	A	G	86	30	116	0	0	116	0	0
14	14533725	.	T	C	3	12	15	0	1	16	0	0
14	21846832	.	A	G	19	29	48	0	2	50	0	0
14	21847779	.	A	G	59	12	71	0	0	71	0	0
14	25924435	.	A	G	5	2	7	0	0	7	0	0
14	26382413	.	T	C	1	2	3	0	0	3	0	0
14	29788070	.	T	C	12	4	16	0	0	16	0	0
14	29788078	.	T	C	14	6	20	0	0	20	0	0
14	30698912	.	A	G	1	2	3	0	1	4	0	0
14	32018582	.	A	G	27	8	35	0	0	35	0	0
14	51013458	.	T	C	6	2	8	0	0	8	0	0
14	51108765	.	A	G	4	2	6	0	0	6	0	0
14	51109987	.	A	G	4	2	6	0	0	6	0	0
14	55749057	.	A	G	19	3	22	0	0	22	0	0
14	55875920	.	T	C	2	2	4	0	0	4	0	0
14	58064703	.	G	T	6	2	8	0	1	9	0	0
14	66969881	.	G	T	3	5	8	0	1	9	0	0
14	75957159	.	T	C	24	8	32	0	0	32	0	0
14	79709368	.	T	C	1	2	3	0	0	3	0	0
14	99552141	.	C	T	4	2	6	1	0	7	0	0
14	103584115	.	T	C	34	11	45	0	1	46	0	0
14	105831918	.	A	G	1	2	3	0	0	3	0	0
14	119113824	.	G	A	3	5	8	0	5	13	0	0
14	121273016	.	A	G	9	5	14	0	1	15	0	0
14	124847012	.	T	C	3	2	5	0	0	5	0	0
15	8187674	.	A	G	7	5	12	0	0	12	0	0
15	8188973	.	A	G	4	5	9	0	3	12	0	0
15	32241361	.	C	G	1	2	3	0	1	4	0	0
15	55118623	.	A	T	11	4	15	0	1	16	0	0
15	55118968	.	A	G	4	2	6	0	0	6	0	0
15	58814046	.	G	A	17	6	23	0	1	24	0	0
15	58814049	.	G	A	17	2	19	0	1	20	0	0
15	61861973	.	C	T	2	2	4	0	0	4	0	0
15	68965365	.	G	A	8	2	10	0	1	11	0	0
15	75525421	.	T	C	3	2	5	0	0	5	0	0
15	76316680	.	A	G	1	2	3	0	0	3	0	0
15	79571382	.	G	A	27	8	35	0	3	38	0	0
15	80816687	.	A	T	13	3	16	0	1	17	0	0
15	89312788	.	C	G	3	1	4	0	1	5	0	0
15	89312792	.	A	G	3	1	4	0	1	5	0	0
15	93293466	.	A	T	4	2	6	0	0	6	0	0
15	98634993	.	T	C	12	26	38	0	0	38	0	0
15	98731431	.	T	C	31	6	37	0	0	37	0	0
15	98932415	.	C	T	1	2	3	170	0	173	0	0
15	99142536	.	T	C	56	15	71	18	0	89	0	0
15	99626091	.	A	G	6	2	8	0	0	8	0	0
16	4696896	.	G	A	4	2	6	0	1	7	0	0
16	13520445	.	A	G	18	8	26	0	1	27	0	0
16	13520501	.	A	G	15	3	18	0	1	19	0	0
16	13651947	.	T	C	11	2	13	0	2	15	0	0
16	17321752	.	A	G	11	2	13	0	1	14	0	0
16	18653678	.	A	G	43	8	51	0	2	53	0	0
16	19942498	.	A	G	26	25	51	0	0	51	0	0
16	30330773	.	T	C	9	4	13	0	1	14	0	0
16	30379865	.	T	C	1	2	3	0	0	3	0	0
16	32119150	.	A	G	15	9	24	0	0	24	0	0
16	35834520	.	A	G	2	2	4	0	0	4	0	0
16	43453695	.	C	T	12	5	17	0	1	18	0	0
16	55722120	.	T	C	13	2	15	0	1	16	0	0
16	59377275	.	A	G	3	2	5	0	0	5	0	0
16	87737431	.	T	C	2	6	8	0	0	8	0	0
16	91453021	.	A	G	68	13	81	0	1	82	0	0
16	91460848	.	G	T	1	2	3	0	2	5	0	0
16	91460850	.	A	T	0	2	2	0	3	5	0	0
17	15695826	.	T	C	3	2	5	0	0	5	0	0
17	15741073	.	A	G	3	4	7	0	0	7	0	0
17	23972976	.	T	C	1	2	3	0	0	3	0	0
17	24397327	.	T	C	17	11	28	0	0	28	0	0
17	27798365	.	C	T	6	2	8	0	0	8	0	0
17	29521001	.	A	G	5	3	8	0	0	8	0	0
17	33015057	.	T	C	6	2	8	0	0	8	0	0
17	33037804	.	T	C	9	2	11	0	1	12	0	0
17	33552004	.	T	C	7	3	10	0	0	10	0	0
17	33904744	.	T	C	4	2	6	0	0	6	0	0
17	33966501	.	T	C	16	3	19	98	2	119	0	0
17	40158498	.	T	C	3180	4049	7229	1	112	7669	327	0
17	40159543	.	T	C	45	274	319	0	0	319	0	0
17	45973875	.	T	C	33	58	91	0	5	96	0	0
17	56482902	.	T	C	3	3	6	0	1	7	0	0
17	56482903	.	T	C	5	2	7	0	0	7	0	0
17	72176760	.	T	C	2	1	3	0	0	3	0	0
17	72176762	.	G	C	2	1	3	0	0	3	0	0
17	80354319	.	T	C	5	1	6	0	0	6	0	0
17	83523140	.	A	G	2	2	4	0	0	4	0	0
17	85932222	.	A	T	4	2	6	0	1	7	0	0
17	95067479	.	T	C	8	12	20	0	0	20	0	0
18	4198427	.	C	A	9	2	11	26	1	38	0	0
18	31974868	.	A	G	1	2	3	0	0	3	0	0
18	32233146	.	A	G	8	5	13	0	0	13	0	0
18	32235930	.	A	G	2	4	6	0	1	7	0	0
18	32236019	.	A	G	5	4	9	0	0	9	0	0
18	32561134	.	A	G	43	5	48	0	0	48	0	0
18	35743341	.	A	G	13	2	15	0	0	15	0	0
18	35807586	.	T	C	73	13	86	0	1	87	0	0
18	37444052	.	A	G	1	2	3	0	0	3	0	0
18	67455507	.	T	C	1	2	3	0	0	3	0	0
18	67455515	.	T	C	2	2	4	0	0	4	0	0
18	82712421	.	T	C	3	3	6	0	0	6	0	0
19	3940459	.	A	G	1	2	3	0	0	3	0	0
19	3940464	.	A	G	2	2	4	0	0	4	0	0
19	4813159	.	T	C	3	2	5	0	0	5	0	0
19	4938619	.	T	C	7	4	11	0	1	12	0	0
19	6392304	.	A	T	24	28	52	0	0	52	0	0
19	7512615	.	A	G	16	3	19	0	0	19	0	0
19	7515480	.	A	G	19	6	25	0	1	26	0	0
19	8750037	.	T	A	8	2	10	0	1	11	0	0
19	8900203	.	A	G	8	2	10	0	1	11	0	0
19	10223060	.	T	C	28	45	73	0	0	73	0	0
19	23185389	.	A	G	10	3	13	0	1	14	0	0
19	34855189	.	C	A	2	2	4	0	0	4	0	0
19	40201618	.	A	G	1	2	3	0	0	3	0	0
19	40585614	.	G	A	13	3	16	0	1	17	0	0
19	43429601	.	A	G	10	13	23	0	0	23	0	0
19	43429686	.	A	G	24	4	28	0	0	28	0	0
19	43429753	.	A	G	21	7	28	0	1	29	0	0
19	44993669	.	T	C	28	6	34	0	1	35	0	0
19	44993727	.	T	C	34	6	40	0	0	40	0	0
19	53920935	.	T	C	3	3	6	0	0	6	0	0
2	3292514	.	A	G	1	2	3	0	0	3	0	0
2	5902666	.	T	C	1	2	3	0	0	3	0	0
2	22477570	.	T	C	2	2	4	14	1	19	0	0
2	26278314	.	A	G	3	2	5	0	0	5	0	0
2	27153718	.	T	C	8	6	14	0	0	14	0	0
2	27887617	.	A	T	8	1	9	0	1	10	0	0
2	27887618	.	A	T	9	1	10	0	0	10	0	0
2	31937444	.	A	G	15	2	17	1	0	18	0	0
2	32173838	.	T	C	3	2	5	0	0	5	0	0
2	32196762	.	A	G	35	5	40	0	0	40	0	0
2	32208556	.	T	C	2	2	4	0	0	4	0	0
2	33048105	.	T	C	7	2	9	0	0	9	0	0
2	37263880	.	G	A	21	5	26	0	0	26	0	0
2	37263886	.	C	A	20	3	23	0	0	23	0	0
2	38614155	.	T	C	8	2	10	0	0	10	0	0
2	91043632	.	A	G	27	5	32	0	0	32	0	0
2	91064808	.	T	C	2	2	4	0	0	4	0	0
2	103584043	.	T	C	1	1	2	0	0	2	0	0
2	104511430	.	T	C	20	3	23	0	0	23	0	0
2	112185846	.	A	G	1	2	3	0	0	3	0	0
2	121223480	.	T	C	3	2	5	0	0	5	0	0
2	127126710	.	A	G	5	2	7	0	0	7	0	0
2	128968268	.	A	G	13	3	16	0	0	16	0	0
2	128968270	.	A	G	15	2	17	0	0	17	0	0
2	129011543	.	T	C	3	2	5	5	0	10	0	0
2	130715824	.	T	A	4	2	6	0	0	6	0	0
2	131130525	.	A	G	6	2	8	0	0	8	0	0
2	132151800	.	A	G	55	225	280	0	3	283	0	0
2	135911813	.	G	A	6	6	12	0	2	14	0	0
2	153108492	.	A	G	7	6	13	0	0	13	0	0
2	154379850	.	A	G	22	8	30	0	0	30	0	0
2	155554923	.	T	C	5	2	7	0	0	7	0	0
2	157400030	.	T	C	61	16	77	5	0	82	0	0
2	158225545	.	A	G	334	79	413	0	1	414	0	0
2	158226873	.	A	G	103	357	460	0	14	474	0	0
2	163309459	.	T	C	9	6	15	0	0	15	0	0
2	164635687	.	T	C	7	7	14	0	0	14	0	0
2	164953773	.	T	C	17	11	28	0	0	28	0	0
2	166408278	.	A	G	11	2	13	0	0	13	0	0
2	174169694	.	A	G	76	14	90	0	5	95	0	0
2	181159604	.	A	G	2	2	4	0	0	4	0	0
3	8626663	.	C	A	5	2	7	0	2	9	0	0
3	8626664	.	T	A	6	2	8	0	0	8	0	0
3	8680419	.	T	G	1	2	3	0	0	3	0	0
3	8680435	.	G	A	1	2	3	0	0	3	0	0
3	19278361	.	T	C	6	3	9	0	0	9	0	0
3	26385911	.	T	C	9	2	11	0	0	11	0	0
3	40748697	.	A	G	32	7	39	12	0	51	0	0
3	54706896	.	A	G	7	4	11	0	0	11	0	0
3	57551908	.	T	C	2	5	7	0	0	7	0	0
3	65866372	.	A	G	4	2	6	0	0	6	0	0
3	80599593	.	T	C	115	170	285	0	3	288	0	0
3	80613850	.	T	C	27	8	35	0	1	36	0	0
3	80614159	.	T	C	7	8	15	0	1	16	0	0
3	80614215	.	T	C	243	78	321	0	1	322	0	0
3	85463819	.	T	C	1	2	3	0	0	3	0	0
3	89675221	.	T	C	7	2	9	0	0	9	0	0
3	95091616	.	T	C	8	2	10	0	0	10	0	0
3	96539776	.	A	G	6	14	20	0	1	21	0	0
3	96540029	.	A	G	21	5	26	0	5	31	0	0
3	102973406	.	A	G	28	10	38	0	1	39	0	0
3	103187243	.	A	G	22	3	25	0	0	25	0	0
3	103542480	.	T	C	2	2	4	0	1	5	0	0
3	104835351	.	A	G	9	5	14	0	0	14	0	0
3	104835352	.	A	G	11	3	14	0	0	14	0	0
3	135112631	.	T	C	43	8	51	0	0	51	0	0
4	33019420	.	A	G	74	13	87	0	3	90	0	0
4	33020417	.	A	G	53	35	88	0	1	89	0	0
4	40702523	.	T	C	4	2	6	0	0	6	0	0
4	41518514	.	T	C	111	24	135	0	1	136	0	0
4	42856686	.	T	C	1	1	2	0	1	3	0	0
4	45377141	.	A	G	7	2	9	0	1	10	0	0
4	56811245	.	T	C	10	2	12	0	0	12	0	0
4	59023876	.	C	T	1	2	3	0	0	3	0	0
4	62371673	.	T	C	3	2	5	0	0	5	0	0
4	62440929	.	A	C	1	2	3	0	0	3	0	0
4	86495344	.	G	T	47	10	57	0	0	57	0	0
4	108198313	.	A	G	5	5	10	0	1	11	0	0
4	108198318	.	A	G	11	2	13	0	0	13	0	0
4	118484005	.	A	G	10	19	29	0	0	29	0	0
4	118484020	.	A	G	22	5	27	0	4	31	0	0
4	118484072	.	A	G	20	6	26	0	1	27	0	0
4	119080668	.	T	C	14	4	18	0	1	19	0	0
4	119080724	.	T	C	13	3	16	0	1	17	0	0
4	119081410	.	T	C	17	2	19	0	1	20	0	0
4	124838094	.	A	G	2	3	5	0	0	5	0	0
4	125982944	.	A	G	3	7	10	0	0	10	0	0
4	125982989	.	A	G	9	2	11	0	1	12	0	0
4	129062390	.	T	C	3	2	5	0	0	5	0	0
4	129062418	.	T	C	1	3	4	0	0	4	0	0
4	129074340	.	T	C	1	2	3	0	0	3	0	0
4	131607349	.	A	G	4	2	6	0	0	6	0	0
4	131679966	.	T	C	25	4	29	0	0	29	0	0
4	133388892	.	T	C	4	3	7	0	0	7	0	0
4	137987341	.	A	G	72	18	90	0	0	90	0	0
4	137987354	.	A	G	61	27	88	0	0	88	0	0
4	140678893	.	A	G	9	2	11	1	0	12	0	0
4	140842602	.	G	A	5	1	6	0	1	7	0	0
4	141870865	.	A	G	1	2	3	0	0	3	0	0
4	149202654	.	A	G	25	4	29	0	0	29	0	0
4	149203211	.	A	G	19	6	25	0	0	25	0	0
4	149552818	.	T	C	4	2	6	1	0	7	0	0
4	155706828	.	A	G	13	3	16	1	2	19	0	0
4	156095123	.	A	G	59	25	84	0	1	85	0	0
5	21159150	.	A	G	1	2	3	0	0	3	0	0
5	29658129	.	A	G	1	4	5	0	0	5	0	0
5	34378554	.	T	C	2	2	4	0	0	4	0	0
5	65605388	.	T	C	54	16	70	0	1	71	0	0
5	65605389	.	T	C	46	21	67	0	2	69	0	0
5	65727371	.	A	G	1	2	3	0	0	3	0	0
5	65727375	.	A	G	1	2	3	0	0	3	0	0
5	75162969	.	T	C	6	3	9	0	0	9	0	0
5	77555578	.	T	C	4	14	18	0	0	18	0	0
5	110413206	.	T	C	2	2	4	0	0	4	0	0
5	110578619	.	G	A	4	8	12	1	0	13	0	0
5	114191896	.	T	C	2	3	5	0	0	5	0	0
5	115435667	.	T	C	23	3	26	0	0	26	0	0
5	120618031	.	T	C	1	2	3	0	0	3	0	0
5	121683511	.	T	C	15	5	20	0	0	20	0	0
5	122546590	.	A	G	11	3	14	0	1	15	0	0
5	122576802	.	C	T	1	2	3	0	0	3	0	0
5	123386729	.	A	G	16	10	26	0	0	26	0	0
5	123510674	.	G	T	5	9	14	0	0	14	0	0
5	125534541	.	A	G	36	25	61	0	1	62	0	0
5	129798517	.	A	G	16	5	21	0	1	22	0	0
5	130014307	.	A	G	37	7	44	0	0	44	0	0
5	130018011	.	A	G	6	2	8	0	0	8	0	0
5	135437709	.	T	C	15	5	20	0	0	20	0	0
5	135437715	.	T	C	11	3	14	0	0	14	0	0
5	135665678	.	A	G	2	3	5	0	0	5	0	0
5	136941953	.	A	G	74	17	91	0	4	95	0	0
5	142655047	.	A	G	82	16	98	0	1	99	0	0
5	142856760	.	T	C	18	4	22	0	1	23	0	0
5	142888875	.	G	T	18	6	24	0	4	28	0	0
5	143696954	.	G	A	12	3	15	0	1	16	0	0
5	143751019	.	A	G	7	2	9	1	0	10	0	0
6	18430637	.	G	A	11	5	16	0	0	16	0	0
6	31489168	.	A	G	7	2	9	0	2	11	0	0
6	31492600	.	A	G	12	3	15	0	0	15	0	0
6	31492602	.	A	G	10	5	15	0	1	16	0	0
6	37847782	.	A	G	6	4	10	0	0	10	0	0
6	37923250	.	A	T	3	2	5	0	0	5	0	0
6	39312088	.	T	C	30	5	35	0	0	35	0	0
6	39312096	.	T	C	29	5	34	0	0	34	0	0
6	47848942	.	A	G	13	2	15	0	0	15	0	0
6	47849226	.	A	G	5	2	7	0	0	7	0	0
6	49231812	.	T	C	12	6	18	0	1	19	0	0
6	52736086	.	A	G	1	2	3	0	0	3	0	0
6	66517625	.	A	G	3	7	10	0	0	10	0	0
6	66517635	.	A	G	8	5	13	0	0	13	0	0
6	86393045	.	A	G	2	2	4	0	0	4	0	0
6	87794049	.	T	C	14	3	17	0	0	17	0	0
6	94599678	.	G	A	7	6	13	0	0	13	0	0
6	96010183	.	T	C	1	2	3	1	0	4	0	0
6	115998165	.	T	A	6	4	10	0	1	11	0	0
6	124717185	.	T	C	3	4	7	0	0	7	0	0
6	125127623	.	A	G	3	2	5	0	0	5	0	0
6	125218480	.	A	G	2	2	4	0	0	4	0	0
6	126619121	.	T	C	41	28	69	0	1	70	0	0
6	128385889	.	A	G	4	2	6	0	0	6	0	0
6	146364908	.	G	A	1	2	3	7	3	13	0	0
6	146364909	.	T	C	4	0	4	7	2	13	0	0
6	146733920	.	A	G	2	2	4	0	0	4	0	0
6	149335593	.	C	T	1	2	3	2	0	5	0	0
7	3386270	.	A	G	9	3	12	0	0	12	0	0
7	3463600	.	A	G	84	18	102	1	3	106	0	0
7	6967217	.	A	G	24	3	27	0	2	29	0	0
7	12600489	.	T	C	2	5	7	0	0	7	0	0
7	12707543	.	A	G	6	2	8	0	0	8	0	0
7	16619272	.	A	G	4	35	39	0	0	39	0	0
7	16619450	.	A	G	13	1	14	0	0	14	0	0
7	16619714	.	A	G	73	10	83	0	2	85	0	0
7	18873753	.	T	C	10	2	12	0	1	13	0	0
7	19240036	.	T	C	10	2	12	0	0	12	0	0
7	19366262	.	T	A	13	2	15	1	1	17	0	0
7	19638449	.	T	A	2	7	9	0	1	10	0	0
7	19638461	.	T	A	6	4	10	0	0	10	0	0
7	25077470	.	A	G	2	2	4	0	0	4	0	0
7	26904993	.	A	G	2	5	7	0	0	7	0	0
7	26905060	.	A	G	7	4	11	0	0	11	0	0
7	27227593	.	T	C	65	14	79	0	0	79	0	0
7	27520956	.	A	G	4	6	10	0	0	10	0	0
7	39217068	.	A	G	13	2	15	0	0	15	0	0
7	45032973	.	T	C	13	3	16	0	0	16	0	0
7	46578166	.	T	C	1	3	4	0	0	4	0	0
7	49206120	.	A	G	3	2	5	0	0	5	0	0
7	58899042	.	T	C	3	3	6	0	0	6	0	0
7	58899786	.	T	C	4	4	8	0	0	8	0	0
7	73387821	.	T	C	3	4	7	0	0	7	0	0
7	79889662	.	A	G	4	2	6	0	0	6	0	0
7	81522050	.	A	G	4	5	9	0	0	9	0	0
7	83274886	.	T	C	7	4	11	0	1	12	0	0
7	83406399	.	G	A	1	2	3	1	0	4	0	0
7	110655309	.	T	C	12	8	20	0	4	24	0	0
7	114126212	.	T	C	12	2	14	0	0	14	0	0
7	123582103	.	A	G	28	3	31	0	1	32	0	0
7	123582585	.	A	G	15	2	17	0	1	18	0	0
7	126631490	.	A	G	2	3	5	0	0	5	0	0
7	126853494	.	A	G	27	9	36	0	0	36	0	0
7	126853784	.	A	G	30	5	35	0	1	36	0	0
7	127165579	.	A	G	1	3	4	0	0	4	0	0
7	127165851	.	A	G	1	3	4	0	0	4	0	0
7	127400704	.	T	C	9	1	10	0	2	12	0	0
7	127400713	.	G	A	12	1	13	0	0	13	0	0
7	127519115	.	A	G	1	5	6	0	0	6	0	0
7	130360893	.	A	T	8	5	13	0	0	13	0	0
7	140916604	.	A	G	26	5	31	0	1	32	0	0
7	142207010	.	T	C	36	12	48	0	3	51	0	0
8	13336085	.	T	C	4	3	7	0	0	7	0	0
8	19747748	.	C	A	4	2	6	9	0	15	0	0
8	20030843	.	C	T	16	3	19	5	0	24	0	0
8	20030855	.	G	A	16	3	19	3	0	22	0	0
8	20698008	.	A	T	15	3	18	18	0	36	0	0
8	20721217	.	A	G	7	2	9	7	0	16	0	0
8	20727130	.	G	A	19	8	27	5	0	32	0	0
8	26084735	.	T	C	1	2	3	0	0	3	0	0
8	26489012	.	A	G	8	3	11	0	0	11	0	0
8	41370800	.	A	G	10	2	12	0	0	12	0	0
8	69766592	.	A	G	7	8	15	1	0	16	0	0
8	70028682	.	T	C	4	2	6	5	0	11	0	0
8	70481589	.	T	C	14	3	17	0	0	17	0	0
8	72977426	.	A	G	5	26	31	0	0	31	0	0
8	75854062	.	A	G	2	2	4	0	0	4	0	0
8	84723069	.	T	A	1	3	4	0	1	5	0	0
8	84976646	.	T	C	3	2	5	0	0	5	0	0
8	84977938	.	T	C	2	2	4	0	0	4	0	0
8	85591856	.	A	G	0	2	2	0	1	3	0	0
8	89088745	.	G	A	2	2	4	0	1	5	0	0
8	92415258	.	T	C	1	4	5	0	1	6	0	0
8	110817217	.	A	G	32	5	37	0	2	39	0	0
8	111754376	.	G	A	3	2	5	0	0	5	0	0
8	123198434	.	T	C	1	2	3	0	0	3	0	0
8	124261954	.	A	G	4	4	8	0	0	8	0	0
8	125620861	.	T	C	16	10	26	0	0	26	0	0
8	125620868	.	T	C	21	4	25	0	4	29	0	0
8	129085652	.	C	T	5	4	9	0	2	11	0	0
9	3386017	.	A	G	9	3	12	0	1	13	0	0
9	3387716	.	A	G	7	5	12	0	0	12	0	0
9	3387771	.	A	G	10	4	14	0	0	14	0	0
9	3387790	.	A	G	9	3	12	0	0	12	0	0
9	4456006	.	T	C	9	16	25	0	0	25	0	0
9	8022080	.	T	C	9	2	11	0	0	11	0	0
9	15196031	.	T	C	5	2	7	0	0	7	0	0
9	19560191	.	A	T	12	0	12	0	2	14	0	0
9	20512857	.	A	G	6	3	9	0	0	9	0	0
9	21667159	.	T	C	4	1	5	0	0	5	0	0
9	21667167	.	T	C	4	2	6	0	0	6	0	0
9	44206372	.	T	C	9	2	11	0	0	11	0	0
9	44221120	.	T	C	2	3	5	0	0	5	0	0
9	44221129	.	T	C	4	2	6	0	0	6	0	0
9	44322503	.	T	C	4	3	7	0	0	7	0	0
9	47764621	.	G	A	14	5	19	0	8	27	0	0
9	55458085	.	G	A	8	3	11	0	1	12	0	0
9	62285048	.	T	C	8	2	10	0	1	12	1	0
9	64093070	.	A	T	13	2	15	0	0	15	0	0
9	65253476	.	A	G	7	3	10	0	0	10	0	0
9	66280873	.	A	G	3	3	6	0	0	6	0	0
9	66280879	.	A	G	2	3	5	0	0	5	0	0
9	72925022	.	A	G	4	2	6	0	0	6	0	0
9	72932724	.	A	G	2	2	4	0	0	4	0	0
9	78076674	.	A	G	13	4	17	0	0	17	0	0
9	95284317	.	C	A	11	4	15	1	6	22	0	0
9	95939293	.	A	G	23	4	27	0	0	27	0	0
9	96777818	.	T	C	3	3	6	173	0	179	0	0
9	98871229	.	A	G	4	2	6	0	0	6	0	0
9	103062470	.	C	A	14	5	19	0	1	20	0	0
9	103062472	.	C	A	5	7	12	0	0	12	0	0
9	107640487	.	T	C	8	3	11	0	0	11	0	0
9	108178883	.	G	A	9	2	11	0	0	11	0	0
9	123349983	.	A	G	11	2	13	0	0	13	0	0
9	124033164	.	C	T	6	2	8	0	1	9	0	0
9	124034058	.	T	G	18	8	26	0	0	26	0	0
X	37697716	.	A	G	5	5	10	0	0	10	0	0
X	40743129	.	A	G	14	123	137	0	0	137	0	0
X	40743165	.	A	G	7	2	9	0	0	9	0	0
X	41621267	.	G	T	8	3	11	0	1	12	0	0
X	55633003	.	T	C	24	3	27	0	0	27	0	0
X	60230025	.	T	A	10	2	12	0	0	12	0	0
X	60231705	.	A	G	12	7	19	0	0	19	0	0
X	69388256	.	T	C	41	5	46	0	1	47	0	0
X	70883164	.	A	G	2	2	4	0	0	4	0	0
X	72774914	.	A	G	6	2	8	0	0	8	0	0
X	73070222	.	A	G	5	3	8	0	1	9	0	0
X	73270468	.	T	C	9	11	20	1	0	21	0	0
X	102620158	.	T	C	7	12	19	0	0	19	0	0
X	102620159	.	T	C	6	13	19	0	0	19	0	0
X	102623385	.	T	C	12	4	16	0	1	17	0	0
X	102623421	.	T	C	9	3	12	0	2	14	0	0
X	132488359	.	C	T	2	4	6	0	2	8	0	0
X	134745475	.	C	A	6	2	8	0	0	8	0	0
X	134745477	.	T	A	2	2	4	0	0	4	0	0
X	138846218	.	T	C	2	2	4	0	0	4	0	0
X	139440280	.	A	T	5	3	8	0	0	8	0	0
X	145978689	.	A	G	45	5	50	0	0	50	0	0
X	149766871	.	T	C	46	11	57	0	5	62	0	0
X	149767614	.	T	C	72	37	109	1	2	112	0	0
X	159360986	.	A	G	17	2	19	0	0	19	0	0
X	166906187	.	T	C	8	2	10	0	0	10	0	0
X	168769068	.	C	T	9	2	11	0	0	11	0	0
