contig	position	variantID	refAllele	altAllele	refCount	altCount	totalCount	lowMAPQDepth	lowBaseQDepth	rawDepth	otherBases	improperPairs
1	9790109	.	T	C	7	2	9	0	0	9	0	0
1	22031785	.	T	C	4	10	14	0	0	14	0	0
1	51506146	.	T	C	1	2	3	0	0	3	0	0
1	51507738	.	T	C	2	1	3	0	1	4	0	0
1	51507771	.	T	C	1	2	3	0	0	3	0	0
1	58635113	.	G	A	1	2	3	0	0	3	0	0
1	59756998	.	A	G	4	2	6	0	0	6	0	0
1	59913367	.	A	G	43	19	62	0	1	63	0	0
1	60517747	.	A	G	42	22	64	1	8	73	0	0
1	63156443	.	A	G	1	6	7	0	0	7	0	0
1	66711873	.	A	G	67	39	106	1	5	112	0	0
1	74631584	.	A	G	5	2	7	0	0	7	0	0
1	75398649	.	A	G	22	5	27	0	1	28	0	0
1	75398708	.	A	G	3	17	20	0	2	22	0	0
1	86275689	.	T	C	26	3	29	0	5	34	0	0
1	86276528	.	T	C	11	5	16	0	1	17	0	0
1	88187311	.	C	T	2	2	4	0	0	4	0	0
1	88187834	.	G	A	1	2	3	0	1	4	0	0
1	88188255	.	C	T	4	2	6	0	0	6	0	0
1	88188277	.	C	G	3	2	5	0	0	5	0	0
1	88188444	.	G	C	1	2	3	0	0	3	0	0
1	88189404	.	C	T	2	3	5	0	0	5	0	0
1	88189563	.	C	T	3	4	7	0	0	7	0	0
1	88189611	.	A	G	2	3	5	0	0	5	0	0
1	88189641	.	G	C	2	3	5	0	0	5	0	0
1	88189668	.	A	G	2	4	6	0	0	6	0	0
1	88189685	.	C	A	3	2	5	0	0	5	0	0
1	88189707	.	C	T	6	2	8	0	1	9	0	0
1	88189784	.	A	G	2	2	4	0	0	4	0	0
1	88189910	.	T	C	3	2	5	0	0	5	0	0
1	88189938	.	C	A	3	2	5	0	0	5	0	0
1	88190661	.	G	C	5	2	7	0	0	7	0	0
1	88190717	.	G	C	6	5	11	0	0	11	0	0
1	88190781	.	C	T	3	2	5	0	1	6	0	0
1	88190921	.	C	T	1	8	9	0	1	10	0	0
1	88191237	.	A	C	12	34	46	0	2	48	0	0
1	88191281	.	A	G	63	7	70	0	0	70	0	0
1	88191320	.	C	T	12	23	35	0	0	35	0	0
1	88191468	.	C	G	5	58	63	0	2	65	0	0
1	88191706	.	G	A	26	7	33	0	0	33	0	0
1	88191710	.	T	C	11	20	31	0	0	31	0	0
1	88191864	.	G	T	56	8	64	0	1	65	0	0
1	88192008	.	C	T	49	11	60	0	6	66	0	0
1	88192048	.	G	C	14	39	53	0	0	53	0	0
1	88192098	.	G	A	44	15	59	0	0	59	0	0
1	88192180	.	G	T	67	8	75	0	0	75	0	0
1	88192184	.	T	A	65	7	72	0	2	74	0	0
1	88192243	.	A	G	8	45	53	0	1	54	0	0
1	88192700	.	G	A	13	35	48	0	0	48	0	0
1	88192756	.	G	A	13	44	57	0	1	58	0	0
1	88192980	.	A	G	4	43	47	2	3	52	0	0
1	88193031	.	C	G	14	18	32	1	1	34	0	0
1	88193194	.	C	T	3	7	10	4	2	16	0	0
1	88193292	.	T	A	1	3	4	7	0	11	0	0
1	88193568	.	A	C	1	4	5	42	0	47	0	0
1	88193917	.	G	A	10	20	30	22	2	54	0	0
1	88194314	.	C	A	41	4	45	8	1	54	0	0
1	88197053	.	T	C	13	19	32	0	0	32	0	0
1	88197991	.	A	G	13	33	46	0	0	46	0	0
1	88200605	.	C	A	1	8	9	0	0	9	0	0
1	88200653	.	A	C	1	11	12	0	0	12	0	0
1	88200771	.	G	A	11	2	13	0	0	13	0	0
1	88200832	.	C	T	6	10	16	0	1	17	0	0
1	88202664	.	A	G	2	3	5	1	0	6	0	0
1	88202772	.	A	T	28	5	33	2	0	35	0	0
1	88204960	.	T	C	3	24	27	1	0	28	0	0
1	128291685	.	G	A	15	4	19	0	1	20	0	0
1	156255182	.	T	C	3	11	14	0	0	14	0	0
1	156255601	.	T	C	6	4	10	0	0	10	0	0
1	160835342	.	T	C	8	2	10	0	0	10	0	0
1	160835343	.	T	C	6	3	9	0	1	10	0	0
1	160839934	.	T	C	4	2	6	0	0	6	0	0
1	180155087	.	T	C	3	2	5	3	1	9	0	0
1	180923652	.	T	C	13	3	16	0	1	17	0	0
1	180924020	.	T	C	20	6	26	0	1	27	0	0
1	183105230	.	A	G	17	3	20	0	1	21	0	0
1	183190594	.	A	G	10	7	17	0	0	17	0	0
1	183190682	.	A	G	15	4	19	0	0	19	0	0
10	5775697	.	A	G	1	3	4	0	0	4	0	0
10	49118584	.	T	C	5	4	9	0	0	9	0	0
10	49118640	.	T	C	12	5	17	0	0	17	0	0
10	49148872	.	T	C	5	33	38	0	0	38	0	0
10	49148885	.	T	C	3	28	31	0	0	31	0	0
10	57383221	.	A	G	2	3	5	0	0	5	0	0
10	57391874	.	C	T	7	4	11	0	0	11	0	0
10	62645542	.	T	C	2	2	4	0	0	4	0	0
10	80784471	.	A	G	7	2	9	0	1	10	0	0
10	81182083	.	T	C	26	5	31	0	0	31	0	0
10	81445420	.	G	A	1	2	3	0	0	3	0	0
10	82486613	.	T	C	17	8	25	0	0	25	0	0
10	93582974	.	C	A	1	2	3	0	0	3	0	0
10	93800484	.	T	C	13	3	16	0	0	16	0	0
10	93801926	.	T	C	6	2	8	0	1	9	0	0
10	93801937	.	T	C	6	3	9	0	0	9	0	0
10	94057224	.	A	G	9	7	16	0	0	16	0	0
10	94057234	.	A	G	11	5	16	0	0	16	0	0
10	126903751	.	T	C	91	14	105	0	2	107	0	0
11	3407590	.	A	G	9	2	11	0	0	11	0	0
11	4091399	.	T	C	13	3	16	0	0	16	0	0
11	4091432	.	T	C	25	3	28	0	1	29	0	0
11	43572939	.	A	G	3	4	7	0	0	7	0	0
11	43572970	.	A	G	5	2	7	0	0	7	0	0
11	43573028	.	A	G	4	3	7	0	0	7	0	0
11	45821425	.	T	C	11	4	15	0	0	15	0	0
11	46163470	.	T	C	103	404	507	0	3	510	0	0
11	52124644	.	A	G	3	3	6	0	0	6	0	0
11	53440228	.	A	G	135	120	255	0	12	267	0	0
11	54730814	.	T	C	14	4	18	0	0	18	0	0
11	68876802	.	T	C	13	2	15	0	3	18	0	0
11	69807381	.	G	A	10	3	13	0	0	13	0	0
11	74747553	.	T	C	1	2	3	0	0	3	0	0
11	75067258	.	T	C	21	12	33	0	0	33	0	0
11	77426880	.	T	C	42	13	55	0	0	55	0	0
11	78736658	.	A	G	14	2	16	0	1	17	0	0
11	87014114	.	A	G	12	2	14	0	0	14	0	0
11	88927134	.	T	C	10	2	12	0	1	13	0	0
11	94431502	.	T	C	10	2	12	0	0	12	0	0
11	94431842	.	T	C	14	2	16	0	0	16	0	0
11	97535690	.	T	C	17	5	22	0	0	22	0	0
11	97536428	.	T	C	17	4	21	0	0	21	0	0
11	97598552	.	A	G	3	2	5	0	0	5	0	0
11	97978020	.	A	G	5	3	8	0	0	8	0	0
11	100488792	.	T	C	10	5	15	0	0	15	0	0
11	100954541	.	G	A	14	2	16	0	0	16	0	0
11	101089557	.	T	C	11	4	15	0	0	15	0	0
11	101089802	.	T	C	5	5	10	0	1	11	0	0
11	102366881	.	A	T	5	1	6	0	3	9	0	0
11	102837091	.	T	C	8	4	12	0	0	12	0	0
11	105068803	.	T	C	2	2	4	0	0	4	0	0
11	105068804	.	T	C	2	2	4	0	0	4	0	0
11	115713779	.	A	C	11	2	13	0	1	14	0	0
11	116303813	.	T	C	4	3	7	0	0	7	0	0
11	116471963	.	T	C	10	43	53	0	3	56	0	0
12	3454168	.	A	G	45	9	54	7	1	62	0	0
12	3454248	.	A	G	18	22	40	5	6	51	0	0
12	15778865	.	A	T	3	3	6	0	1	7	0	0
12	17479809	.	A	G	17	12	29	0	1	30	0	0
12	46747117	.	T	C	45	12	57	0	1	58	0	0
12	51418190	.	A	G	1	2	3	0	0	3	0	0
12	54718540	.	T	C	30	15	45	0	0	45	0	0
12	54719070	.	T	C	37	5	42	0	0	42	0	0
12	54719142	.	T	C	25	6	31	0	0	31	0	0
12	69244102	.	A	G	16	6	22	0	0	22	0	0
12	71041403	.	A	G	6	33	39	0	0	39	0	0
12	71041945	.	A	G	19	7	26	0	2	28	0	0
12	73975614	.	A	G	4	4	8	0	0	8	0	0
12	75678010	.	C	T	4	3	7	5	0	12	0	0
12	78887986	.	T	C	5	3	8	0	1	9	0	0
12	81245339	.	G	A	15	16	31	0	1	32	0	0
12	81419057	.	T	C	2	2	4	0	0	4	0	0
12	81419593	.	T	C	2	2	4	0	1	5	0	0
12	83582758	.	G	A	1	2	3	0	0	3	0	0
12	101886131	.	T	C	17	7	24	0	1	25	0	0
12	101887890	.	T	C	14	6	20	0	0	20	0	0
12	104206650	.	C	G	1	3	4	42	0	46	0	0
12	109511197	.	C	A	10	4	14	0	14	28	0	0
12	116018543	.	A	G	1	5	6	0	1	7	0	0
12	116369364	.	G	C	1	5	6	0	0	6	0	0
13	8901801	.	T	C	13	3	16	0	0	16	0	0
13	14225628	.	T	C	29	4	33	0	4	37	0	0
13	14228102	.	T	C	25	6	31	0	2	33	0	0
13	17978887	.	T	C	7	3	10	0	0	10	0	0
13	17979133	.	T	C	5	3	8	0	0	8	0	0
13	21571267	.	G	T	2	2	4	0	0	4	0	0
13	21571270	.	C	T	4	1	5	0	1	6	0	0
13	21574169	.	T	C	6	5	11	0	0	11	0	0
13	21574225	.	T	C	12	5	17	0	0	17	0	0
13	38401726	.	T	C	3	2	5	0	0	5	0	0
13	59757017	.	A	G	3	2	5	0	0	5	0	0
13	64438124	.	T	C	12	3	15	0	0	15	0	0
13	67967482	.	T	C	2	2	4	0	0	4	0	0
13	67967727	.	T	C	2	3	5	0	0	5	0	0
13	75793018	.	G	A	12	3	15	50	1	66	0	0
13	92521565	.	C	G	5	2	7	0	0	7	0	0
13	100202931	.	A	G	1	2	3	0	0	3	0	0
13	119625401	.	G	T	12	4	16	0	0	16	0	0
13	120230616	.	T	C	1	2	3	0	0	3	0	0
14	9647289	.	A	G	71	11	82	0	0	82	0	0
14	10058181	.	A	G	121	47	168	0	5	174	1	0
14	14533725	.	T	C	4	17	21	0	1	22	0	0
14	20418433	.	A	G	10	2	12	0	1	13	0	0
14	21846832	.	A	G	17	40	57	0	4	61	0	0
14	21846833	.	A	G	48	13	61	0	0	61	0	0
14	21847779	.	A	G	75	24	99	0	0	99	0	0
14	26381874	.	T	C	5	2	7	0	0	7	0	0
14	26381875	.	T	C	5	2	7	0	0	7	0	0
14	26382360	.	T	C	5	5	10	0	0	10	0	0
14	29788078	.	T	C	14	7	21	0	0	21	0	0
14	32018582	.	A	G	26	9	35	0	0	35	0	0
14	51013458	.	T	C	8	4	12	0	0	12	0	0
14	51109987	.	A	G	6	4	10	0	0	10	0	0
14	52435637	.	A	G	5	2	7	0	1	8	0	0
14	55658193	.	A	G	2	1	3	0	2	5	0	0
14	55749057	.	A	G	8	4	12	0	0	12	0	0
14	55787563	.	A	G	2	3	5	0	0	5	0	0
14	59883055	.	A	G	7	2	9	0	2	11	0	0
14	60451313	.	T	C	3	5	8	0	0	8	0	0
14	65291200	.	A	G	14	3	17	0	25	42	0	0
14	75957159	.	T	C	23	8	31	0	1	32	0	0
14	99552141	.	C	T	3	2	5	0	0	5	0	0
14	103584115	.	T	C	21	8	29	0	0	29	0	0
14	118470948	.	C	T	3	1	4	0	1	5	0	0
14	121273016	.	A	G	4	3	7	0	0	7	0	0
15	8187674	.	A	G	13	9	22	0	0	22	0	0
15	8187696	.	A	G	13	3	16	0	1	17	0	0
15	8188973	.	A	G	6	4	10	0	2	12	0	0
15	55116094	.	A	G	9	2	11	0	0	11	0	0
15	58695035	.	T	C	22	3	25	0	0	25	0	0
15	66158075	.	T	C	12	2	14	0	1	15	0	0
15	75525421	.	T	C	2	3	5	0	1	6	0	0
15	79133222	.	G	A	17	16	33	0	1	34	0	0
15	79496070	.	T	C	6	3	9	0	0	9	0	0
15	81791419	.	A	G	4	2	6	0	0	6	0	0
15	82015818	.	A	G	2	3	5	0	0	5	0	0
15	84836683	.	T	C	7	3	10	0	0	10	0	0
15	98634993	.	T	C	18	33	51	0	1	52	0	0
15	98731431	.	T	C	22	6	28	0	0	28	0	0
15	99142536	.	T	C	68	19	87	10	3	100	0	0
15	99626091	.	A	G	7	2	9	0	0	9	0	0
16	3680985	.	T	C	16	3	19	0	1	20	0	0
16	13283445	.	A	G	1	2	3	0	0	3	0	0
16	13520445	.	A	G	19	5	24	0	0	24	0	0
16	13520501	.	A	G	10	2	12	0	0	12	0	0
16	13576064	.	A	G	1	2	3	0	0	3	0	0
16	13651947	.	T	C	24	5	29	0	2	31	0	0
16	17321752	.	A	G	14	5	19	0	0	19	0	0
16	18653678	.	A	G	57	20	77	0	2	79	0	0
16	19942498	.	A	G	39	27	66	0	1	67	0	0
16	20508413	.	A	G	7	2	9	0	0	9	0	0
16	30330773	.	T	C	10	3	13	0	0	13	0	0
16	32119150	.	A	G	26	12	38	0	0	38	0	0
16	78133495	.	A	G	3	2	5	0	0	5	0	0
16	87230813	.	T	C	12	2	14	0	0	14	0	0
16	87230814	.	T	C	11	3	14	0	0	14	0	0
16	87737431	.	T	C	4	8	12	0	1	13	0	0
16	91453021	.	A	G	75	16	91	0	1	92	0	0
16	92336842	.	C	T	9	2	11	0	1	12	0	0
16	97658408	.	T	C	3	3	6	0	0	6	0	0
17	15695793	.	T	C	4	2	6	0	0	6	0	0
17	15741073	.	A	G	5	4	9	0	0	9	0	0
17	18132829	.	C	T	2	2	4	1	0	5	0	0
17	24397327	.	T	C	10	14	24	0	1	25	0	0
17	24635698	.	A	G	6	4	10	0	0	10	0	0
17	24635786	.	A	G	9	2	11	0	1	12	0	0
17	27721769	.	T	C	9	3	12	0	0	12	0	0
17	28392510	.	C	T	1	2	3	0	0	3	0	0
17	29521001	.	A	G	6	4	10	0	1	11	0	0
17	29919711	.	G	T	2	4	6	0	0	6	0	0
17	32063514	.	C	A	1	3	4	0	3	7	0	0
17	33552004	.	T	C	10	4	14	0	0	14	0	0
17	33867517	.	T	C	4	2	6	0	0	6	0	0
17	34147531	.	A	G	21	11	32	0	2	34	0	0
17	40158498	.	T	C	3531	4706	8237	3	128	8792	424	0
17	45973875	.	T	C	42	78	120	0	9	129	0	0
17	50586902	.	G	A	3	3	6	0	0	6	0	0
17	62088129	.	T	C	1	3	4	1	0	5	0	0
17	63806215	.	T	C	15	4	19	0	0	19	0	0
17	87386211	.	G	A	1	1	2	2	2	6	0	0
17	95067479	.	T	C	11	10	21	0	1	22	0	0
17	95068552	.	T	C	36	7	43	0	0	43	0	0
18	6792802	.	A	G	15	5	20	0	0	20	0	0
18	24097917	.	A	G	7	5	12	0	0	12	0	0
18	24639050	.	T	C	9	2	11	0	0	11	0	0
18	32235930	.	A	G	3	5	8	0	0	8	0	0
18	32236019	.	A	G	6	4	10	0	0	10	0	0
18	32561134	.	A	G	29	16	45	0	0	45	0	0
18	35743341	.	A	G	11	2	13	0	0	13	0	0
18	35935410	.	A	G	5	3	8	0	0	8	0	0
18	46869696	.	T	C	8	2	10	0	0	10	0	0
18	59543586	.	A	T	5	2	7	0	0	7	0	0
18	65610148	.	A	G	4	2	6	0	0	6	0	0
19	4813117	.	T	C	11	2	13	0	0	13	0	0
19	5015429	.	A	G	3	2	5	0	0	5	0	0
19	7515480	.	A	G	18	5	23	0	0	23	0	0
19	10223060	.	T	C	31	56	87	0	2	89	0	0
19	10885930	.	A	G	2	3	5	0	1	6	0	0
19	10886122	.	A	G	4	2	6	0	0	6	0	0
19	10886159	.	A	G	3	2	5	0	0	5	0	0
19	12441626	.	A	G	29	5	34	0	0	34	0	0
19	43429365	.	A	G	20	3	23	0	0	23	0	0
19	43429601	.	A	G	15	15	30	0	0	31	1	0
19	43429686	.	A	G	34	4	38	0	0	38	0	0
19	43429753	.	A	G	32	8	40	0	0	40	0	0
19	44993669	.	T	C	29	8	37	0	1	38	0	0
19	44993727	.	T	C	49	6	55	0	0	55	0	0
19	46269407	.	A	G	1	2	3	0	0	3	0	0
2	5902865	.	T	C	2	2	4	0	0	4	0	0
2	10261256	.	C	T	6	2	8	0	0	8	0	0
2	22479057	.	T	C	1	3	4	3	4	11	0	0
2	25597684	.	T	A	7	2	9	0	0	9	0	0
2	25597686	.	C	A	7	2	9	0	0	9	0	0
2	26846568	.	T	C	5	2	7	0	0	7	0	0
2	26848217	.	T	C	6	3	9	0	0	9	0	0
2	31040896	.	T	C	1	2	3	0	0	3	0	0
2	31505906	.	A	G	13	2	15	0	0	15	0	0
2	31937444	.	A	G	18	2	20	0	1	21	0	0
2	32174582	.	T	C	5	2	7	0	0	7	0	0
2	38902454	.	A	G	3	2	5	0	0	5	0	0
2	40445910	.	G	T	0	3	3	4	3	10	0	0
2	59185548	.	G	A	6	2	8	0	0	8	0	0
2	59185550	.	G	A	1	2	3	0	0	3	0	0
2	66314260	.	G	C	1	4	5	3	0	8	0	0
2	66314290	.	A	C	2	3	5	0	1	6	0	0
2	80668540	.	G	A	0	3	3	6	2	11	0	0
2	91043632	.	A	G	45	11	56	0	0	56	0	0
2	91551466	.	A	G	9	2	11	0	1	12	0	0
2	102612558	.	T	A	206	57	263	1	21	285	0	0
2	104511430	.	T	C	13	4	17	0	0	17	0	0
2	112185846	.	A	G	2	4	6	0	0	6	0	0
2	112185852	.	A	G	4	2	6	0	0	6	0	0
2	117173318	.	C	A	123	82	205	0	2	207	0	0
2	118700801	.	A	G	11	3	14	0	0	14	0	0
2	120451649	.	A	G	24	3	27	5	0	32	0	0
2	120988975	.	A	G	4	2	6	0	0	6	0	0
2	121015462	.	A	G	1	3	4	0	0	4	0	0
2	121374228	.	A	G	3	4	7	0	0	7	0	0
2	122199390	.	T	C	11	2	13	0	4	17	0	0
2	128968268	.	A	G	13	2	15	0	0	15	0	0
2	132151800	.	A	G	35	298	333	0	7	340	0	0
2	152114942	.	A	G	3	8	11	0	0	11	0	0
2	153108492	.	A	G	16	3	19	0	0	19	0	0
2	154379850	.	A	G	34	9	43	0	0	43	0	0
2	155980520	.	T	C	3	3	6	0	0	6	0	0
2	157400030	.	T	C	108	15	123	9	4	136	0	0
2	158225545	.	A	G	371	50	421	0	4	425	0	0
2	158226873	.	A	G	114	327	441	0	21	462	0	0
2	163309459	.	T	C	9	15	24	0	0	24	0	0
2	164266227	.	T	A	2	0	2	0	3	5	0	0
2	164953773	.	T	C	35	11	46	0	0	46	0	0
2	168055230	.	T	C	4	2	6	0	1	7	0	0
2	169913325	.	A	G	3	5	8	0	0	8	0	0
2	169913421	.	A	G	7	6	13	0	1	14	0	0
2	174169694	.	A	G	134	39	173	1	2	176	0	0
3	19278361	.	T	C	2	2	4	0	0	4	0	0
3	26385911	.	T	C	17	3	20	0	0	20	0	0
3	32636549	.	T	C	12	9	21	0	0	21	0	0
3	36146600	.	A	G	2	2	4	0	0	4	0	0
3	40748697	.	A	G	45	8	53	10	0	63	0	0
3	57551841	.	T	C	1	2	3	0	0	3	0	0
3	63929640	.	T	A	3	2	5	0	0	5	0	0
3	65866372	.	A	G	4	2	6	0	0	6	0	0
3	65868019	.	A	G	7	2	9	0	0	9	0	0
3	80599593	.	T	C	125	198	323	3	5	331	0	0
3	80613850	.	T	C	16	2	18	0	0	18	0	0
3	80614159	.	T	C	10	9	19	0	0	19	0	0
3	80614215	.	T	C	266	105	371	1	6	378	0	0
3	88259542	.	A	G	12	3	15	0	0	15	0	0
3	88259584	.	A	G	4	4	8	0	0	8	0	0
3	89675221	.	T	C	10	2	12	0	0	12	0	0
3	93353627	.	A	T	8	1	9	0	0	9	0	0
3	93353631	.	C	A	8	1	9	0	0	9	0	0
3	94311127	.	G	A	3	2	5	0	0	5	0	0
3	94794244	.	T	A	13	3	16	0	0	16	0	0
3	94794245	.	G	A	13	3	16	0	0	16	0	0
3	94921221	.	T	G	3	1	4	0	2	6	0	0
3	96539776	.	A	G	2	21	23	0	1	24	0	0
3	96540029	.	A	G	18	5	23	0	1	24	0	0
3	102973406	.	A	G	32	12	44	0	2	46	0	0
3	104835352	.	A	G	5	4	9	0	0	9	0	0
3	135112631	.	T	C	53	9	62	0	0	62	0	0
4	21836550	.	A	G	41	6	47	0	0	47	0	0
4	21911886	.	A	G	14	3	17	0	0	17	0	0
4	32022582	.	A	G	37	5	42	0	0	42	0	0
4	33019420	.	A	G	79	19	98	0	1	99	0	0
4	33020417	.	A	G	68	60	128	0	1	129	0	0
4	33945697	.	T	C	39	36	75	0	1	76	0	0
4	41518514	.	T	C	187	32	219	0	4	223	0	0
4	45377141	.	A	G	12	3	15	0	1	16	0	0
4	86495344	.	G	T	52	15	67	1	4	73	1	0
4	103021909	.	A	G	18	5	23	0	1	24	0	0
4	108198313	.	A	G	3	3	6	0	1	7	0	0
4	108690513	.	T	C	9	2	11	0	0	11	0	0
4	116409401	.	T	C	11	2	13	0	0	13	0	0
4	118484005	.	A	G	10	18	28	0	0	28	0	0
4	118484020	.	A	G	35	4	39	0	0	39	0	0
4	119080668	.	T	C	7	5	12	0	0	12	0	0
4	119081410	.	T	C	17	3	20	0	0	20	0	0
4	124832762	.	A	G	3	2	5	0	0	5	0	0
4	124832765	.	A	G	1	3	4	0	0	4	0	0
4	124838094	.	A	G	15	9	24	0	1	25	0	0
4	125982944	.	A	G	9	8	17	0	1	18	0	0
4	125982950	.	A	G	11	4	15	0	1	16	0	0
4	125982989	.	A	G	10	2	12	0	0	12	0	0
4	131679966	.	T	C	18	4	22	0	1	23	0	0
4	137987341	.	A	G	75	19	94	0	0	94	0	0
4	137987354	.	A	G	65	28	93	0	1	94	0	0
4	141488012	.	T	C	45	8	53	0	0	53	0	0
4	144314687	.	A	G	4	3	7	24	0	31	0	0
4	148140817	.	A	G	13	3	16	0	0	16	0	0
4	149202654	.	A	G	34	4	38	0	1	39	0	0
4	149203211	.	A	G	17	5	22	0	1	23	0	0
4	149552635	.	T	C	3	5	8	0	2	10	0	0
4	154049751	.	G	A	8	2	10	0	1	11	0	0
4	155706828	.	A	G	18	3	21	1	1	23	0	0
4	155800382	.	A	G	12	2	14	0	0	14	0	0
4	155800977	.	A	G	8	2	10	0	0	10	0	0
4	156095123	.	A	G	76	42	118	0	1	119	0	0
5	24649635	.	T	C	22	4	26	0	2	28	0	0
5	29658129	.	A	G	1	2	3	0	0	3	0	0
5	31330824	.	T	C	7	5	12	0	0	12	0	0
5	54155989	.	A	C	2	4	6	0	1	8	1	0
5	65605388	.	T	C	60	16	76	0	2	78	0	0
5	65605389	.	T	C	41	33	74	0	4	78	0	0
5	77555578	.	T	C	3	13	16	0	0	17	1	0
5	104652843	.	A	G	21	7	28	0	0	28	0	0
5	104652845	.	A	G	22	7	29	0	1	30	0	0
5	111602776	.	C	T	11	1	12	0	2	14	0	0
5	114894305	.	T	C	1	1	2	0	0	2	0	0
5	115435667	.	T	C	36	4	40	0	1	41	0	0
5	121581241	.	T	C	2	2	4	0	0	4	0	0
5	121941595	.	A	G	2	3	5	0	0	5	0	0
5	122546790	.	A	G	12	2	14	0	0	14	0	0
5	123386729	.	A	G	20	11	31	0	0	31	0	0
5	123880062	.	T	C	8	2	10	0	0	10	0	0
5	125534541	.	A	G	53	22	75	1	0	76	0	0
5	129892662	.	A	G	17	3	20	0	0	20	0	0
5	130014307	.	A	G	65	7	72	0	0	72	0	0
5	135192126	.	A	G	8	2	10	0	0	10	0	0
5	135192160	.	A	G	6	1	7	0	1	8	0	0
5	135402657	.	A	G	1	2	3	0	0	3	0	0
5	135437709	.	T	C	14	3	17	0	2	19	0	0
5	136941953	.	A	G	79	20	99	0	0	99	0	0
5	142655047	.	A	G	82	24	106	0	1	107	0	0
5	143381709	.	A	G	7	2	9	0	0	9	0	0
5	143382034	.	A	G	8	2	10	0	0	10	0	0
5	143382050	.	A	G	3	7	10	0	0	10	0	0
5	143382388	.	A	G	3	4	7	0	0	7	0	0
5	143382882	.	A	G	6	2	8	0	0	8	0	0
5	143751066	.	A	G	11	3	14	1	0	15	0	0
5	143883169	.	A	G	1	2	3	0	0	3	0	0
5	150561734	.	T	C	13	2	15	0	0	15	0	0
6	17990026	.	C	T	1	8	9	0	0	9	0	0
6	18145017	.	T	C	1	2	3	0	0	3	0	0
6	18429956	.	G	A	1	8	9	0	1	10	0	0
6	18430049	.	T	C	1	12	13	0	0	13	0	0
6	31492600	.	A	G	18	3	21	0	3	24	0	0
6	31492602	.	A	G	11	9	20	0	2	22	0	0
6	34854609	.	A	G	11	2	13	0	1	14	0	0
6	37847782	.	A	G	6	6	12	0	1	13	0	0
6	38265837	.	T	C	7	2	9	0	0	9	0	0
6	39312088	.	T	C	17	7	24	0	1	25	0	0
6	39312096	.	T	C	22	3	25	0	0	25	0	0
6	47849226	.	A	G	6	3	9	0	0	9	0	0
6	49233394	.	T	C	12	3	15	0	0	15	0	0
6	61288779	.	C	T	1	10	11	0	0	11	0	0
6	61288787	.	G	A	1	12	13	0	0	13	0	0
6	65687724	.	A	G	2	3	5	0	0	5	0	0
6	66517065	.	A	G	5	5	10	0	0	10	0	0
6	66517625	.	A	G	8	6	14	0	0	14	0	0
6	66517635	.	A	G	12	2	14	0	0	14	0	0
6	67273501	.	A	G	8	4	12	0	0	12	0	0
6	70743250	.	G	T	8	2	10	0	1	11	0	0
6	71791046	.	T	C	13	2	15	0	0	15	0	0
6	87067469	.	A	T	1	7	8	0	0	8	0	0
6	87113982	.	G	C	0	7	7	0	0	7	0	0
6	87113983	.	T	C	1	7	8	0	0	8	0	0
6	87791772	.	T	C	7	3	10	0	0	10	0	0
6	87791783	.	T	C	7	2	9	0	0	9	0	0
6	87795142	.	T	C	9	3	12	0	0	12	0	0
6	91880140	.	A	G	1	2	3	0	0	3	0	0
6	96010042	.	T	C	2	3	5	3	1	9	0	0
6	99497627	.	C	T	8	3	11	1	0	12	0	0
6	118454383	.	C	G	1	9	10	0	0	10	0	0
6	118478591	.	C	T	2	13	15	0	0	15	0	0
6	118500305	.	C	T	1	7	8	0	0	8	0	0
6	118500320	.	A	G	1	5	6	0	2	8	0	0
6	118566170	.	T	C	8	6	14	2	1	17	0	0
6	118566174	.	C	T	14	4	18	2	0	21	1	0
6	119194385	.	A	G	1	5	6	0	0	6	0	0
6	120743411	.	C	T	1	6	7	0	0	7	0	0
6	120746026	.	A	G	1	2	3	0	0	3	0	0
6	122715481	.	T	C	3	2	5	0	0	5	0	0
6	124787056	.	A	C	3	2	5	0	0	5	0	0
6	125217465	.	A	G	4	2	6	0	0	6	0	0
6	126619121	.	T	C	67	33	100	0	2	102	0	0
6	134518327	.	C	G	9	2	11	0	0	11	0	0
6	138399546	.	A	G	27	2	29	1	1	31	0	0
6	146733792	.	A	G	2	2	4	0	0	4	0	0
7	3386270	.	A	G	4	3	7	0	0	7	0	0
7	3463600	.	A	G	105	18	123	0	5	128	0	0
7	6357880	.	A	G	2	3	5	0	0	5	0	0
7	6357928	.	A	G	5	2	7	0	0	7	0	0
7	6358535	.	A	G	7	2	9	0	0	9	0	0
7	6678646	.	T	C	1	5	6	0	0	6	0	0
7	6967217	.	A	G	33	4	37	0	1	38	0	0
7	6969571	.	C	T	1	11	12	0	1	13	0	0
7	7272299	.	C	T	1	3	4	0	0	4	0	0
7	12212392	.	A	G	9	3	12	0	0	12	0	0
7	12706157	.	A	G	7	5	12	0	0	12	0	0
7	12707543	.	A	G	4	2	6	0	0	6	0	0
7	12707548	.	A	G	2	3	5	0	0	5	0	0
7	15887215	.	C	T	1	268	269	0	6	275	0	0
7	16515475	.	T	A	2	4	6	0	0	6	0	0
7	16589769	.	A	G	1	3	4	0	0	4	0	0
7	16619272	.	A	G	8	43	51	1	0	52	0	0
7	16619450	.	A	G	11	2	13	0	0	13	0	0
7	16619714	.	A	G	65	20	85	0	2	87	0	0
7	16728876	.	G	C	1	4	5	0	0	5	0	0
7	18873733	.	T	C	5	3	8	0	0	8	0	0
7	19240036	.	T	C	15	2	17	1	1	19	0	0
7	19638449	.	T	A	2	6	8	0	0	8	0	0
7	19638461	.	T	A	2	3	5	0	0	5	0	0
7	23933876	.	G	A	2	3	5	4	0	9	0	0
7	26904992	.	A	G	7	2	9	0	0	9	0	0
7	26905060	.	A	G	4	5	9	0	0	9	0	0
7	27227593	.	T	C	43	5	48	0	0	48	0	0
7	27520956	.	A	G	6	4	10	0	0	10	0	0
7	27663968	.	C	T	2	6	8	4	1	13	0	0
7	28922523	.	T	C	8	2	10	0	0	10	0	0
7	30126576	.	A	G	1	2	3	0	0	3	0	0
7	34746035	.	T	C	5	2	7	0	0	7	0	0
7	35090723	.	A	G	10	4	14	0	1	15	0	0
7	39238482	.	A	G	1	3	4	1	1	6	0	0
7	43174884	.	T	C	5	2	7	0	0	7	0	0
7	45032973	.	T	C	5	5	10	0	0	10	0	0
7	45141114	.	T	C	3	3	6	0	1	7	0	0
7	49205135	.	A	G	1	2	3	0	0	3	0	0
7	58900772	.	A	G	11	2	13	0	0	13	0	0
7	64521454	.	A	T	5	2	7	0	0	7	0	0
7	73388713	.	T	C	11	2	13	0	0	13	0	0
7	79206023	.	A	G	26	4	30	0	0	30	0	0
7	81522050	.	A	G	3	4	7	0	0	7	0	0
7	81522943	.	A	G	5	3	8	0	0	8	0	0
7	101561470	.	A	G	8	2	10	0	1	11	0	0
7	105289724	.	T	C	2	0	2	0	6	8	0	0
7	110655309	.	T	C	21	11	32	1	1	34	0	0
7	121306558	.	T	C	21	3	24	0	0	24	0	0
7	123582585	.	A	G	15	3	18	0	0	18	0	0
7	126389767	.	T	C	1	2	3	0	0	3	0	0
7	126853494	.	A	G	26	10	36	0	1	37	0	0
7	126853784	.	A	G	54	6	60	0	0	60	0	0
7	127519115	.	A	G	1	4	5	0	0	5	0	0
7	130360893	.	A	T	3	9	12	0	1	13	0	0
7	139715640	.	A	G	2	3	5	0	0	5	0	0
7	139716520	.	A	G	4	2	6	0	0	6	0	0
7	142207010	.	T	C	51	16	67	0	0	68	1	0
7	144133383	.	T	C	1	2	3	0	0	3	0	0
8	14140659	.	G	A	35	4	39	0	0	39	0	0
8	14140661	.	A	C	33	4	37	0	1	38	0	0
8	19737779	.	A	G	8	2	10	6	0	16	0	0
8	19737782	.	C	G	8	2	10	6	0	16	0	0
8	19741629	.	C	T	4	2	6	2	0	8	0	0
8	19747710	.	G	A	6	4	10	6	0	16	0	0
8	20698008	.	A	T	28	5	33	18	1	52	0	0
8	20727130	.	G	A	27	13	40	1	0	41	0	0
8	42700188	.	T	C	2	4	6	1	0	7	0	0
8	42700384	.	A	G	0	2	2	3	1	6	0	0
8	47546763	.	T	G	1	7	8	0	0	8	0	0
8	55134560	.	C	G	18	2	20	0	1	21	0	0
8	70007507	.	T	C	3	2	5	2	0	7	0	0
8	70017218	.	C	G	2	5	7	11	0	18	0	0
8	70017232	.	G	A	2	3	5	4	0	9	0	0
8	72977426	.	A	G	19	38	57	0	1	58	0	0
8	73269626	.	T	C	1	7	8	0	0	8	0	0
8	73269630	.	T	C	1	6	7	0	0	7	0	0
8	80784536	.	G	A	2	2	4	0	0	4	0	0
8	88685947	.	T	C	3	2	5	0	0	5	0	0
8	94879775	.	A	C	1	1	2	0	4	6	0	0
8	94879781	.	A	C	0	2	2	0	3	5	0	0
8	96468587	.	G	A	27	25	52	0	0	52	0	0
8	104986580	.	A	G	1	2	3	0	0	3	0	0
8	110817217	.	A	G	26	6	32	0	2	34	0	0
8	111731758	.	T	C	19	6	25	0	0	25	0	0
8	122566751	.	C	T	1	2	3	0	0	3	0	0
8	123198434	.	T	C	2	4	6	0	0	6	0	0
8	124261954	.	A	G	5	2	7	0	0	7	0	0
8	125620861	.	T	C	30	8	38	0	0	38	0	0
8	129979572	.	C	A	0	2	2	7	1	10	0	0
9	3387716	.	A	G	16	3	19	0	0	19	0	0
9	3387771	.	A	G	17	11	28	0	0	28	0	0
9	4456006	.	T	C	3	35	38	0	0	38	0	0
9	20357181	.	A	G	4	3	7	0	0	7	0	0
9	20515715	.	A	G	3	2	5	0	0	5	0	0
9	43957544	.	A	G	7	2	9	0	0	9	0	0
9	44206375	.	T	C	15	2	17	0	0	17	0	0
9	51534505	.	T	C	2	4	6	0	1	7	0	0
9	51534649	.	G	T	1	2	3	0	0	3	0	0
9	51535071	.	T	C	1	2	3	0	0	3	0	0
9	51535078	.	A	G	1	2	3	0	0	3	0	0
9	51914150	.	T	G	1	2	3	0	0	3	0	0
9	53311221	.	A	G	7	2	9	0	1	10	0	0
9	57658827	.	C	T	8	2	10	0	0	10	0	0
9	65253476	.	A	G	8	2	10	0	1	11	0	0
9	65253551	.	A	G	13	2	15	0	0	15	0	0
9	65595677	.	A	G	8	2	10	0	0	10	0	0
9	67127254	.	T	C	26	3	29	0	0	29	0	0
9	72381503	.	T	C	2	2	4	0	0	4	0	0
9	72635965	.	A	G	3	3	6	0	0	6	0	0
9	88329174	.	T	C	1	2	3	0	0	3	0	0
9	89097389	.	G	A	13	2	15	0	0	15	0	0
9	95284317	.	C	A	13	3	16	0	6	22	0	0
9	95939293	.	A	G	18	6	24	0	1	25	0	0
9	107436552	.	A	G	3	2	5	0	0	5	0	0
9	107640487	.	T	C	1	2	3	0	0	3	0	0
9	108178884	.	G	A	13	2	15	0	2	17	0	0
X	7773818	.	A	G	8	2	10	0	1	11	0	0
X	40743165	.	A	G	1	12	13	0	0	13	0	0
X	41621267	.	G	T	12	2	14	0	2	16	0	0
X	55633003	.	T	C	35	9	44	0	0	44	0	0
X	56429832	.	C	A	16	3	19	0	4	23	0	0
X	60231705	.	A	G	7	11	18	0	0	18	0	0
X	60829523	.	G	A	1	2	3	10	0	13	0	0
X	70335535	.	G	A	3	2	5	0	0	5	0	0
X	73270255	.	T	C	7	4	11	0	0	11	0	0
X	73270468	.	T	C	9	10	19	0	0	19	0	0
X	102620158	.	T	C	2	9	11	0	0	11	0	0
X	102620159	.	T	C	2	9	11	0	0	11	0	0
X	102623385	.	T	C	7	4	11	0	3	14	0	0
X	102623421	.	T	C	8	2	10	0	0	10	0	0
X	103389699	.	G	A	0	4	4	2	2	8	0	0
X	103389705	.	T	A	3	0	3	30	2	35	0	0
X	105976011	.	T	C	1	2	3	0	0	3	0	0
X	106830700	.	T	C	49	8	57	0	1	58	0	0
X	140507620	.	T	C	2	3	5	0	0	5	0	0
X	145978689	.	A	G	66	20	86	0	4	90	0	0
X	149766871	.	T	C	28	6	34	0	5	39	0	0
X	149767614	.	T	C	82	77	159	1	7	167	0	0
X	164972992	.	A	G	8	2	10	4	0	14	0	0
Y	1016394	.	A	G	14	10	24	0	0	24	0	0
