contig	position	variantID	refAllele	altAllele	refCount	altCount	totalCount	lowMAPQDepth	lowBaseQDepth	rawDepth	otherBases	improperPairs
1	10101774	.	T	C	3	3	6	0	0	6	0	0
1	16717060	.	T	C	2	2	4	0	1	5	0	0
1	22031785	.	T	C	9	7	16	0	0	16	0	0
1	25869887	.	G	T	1	3	4	0	0	4	0	0
1	33835733	.	T	C	12	2	14	0	1	15	0	0
1	33835828	.	T	C	13	2	15	0	0	15	0	0
1	38906327	.	T	C	1	2	3	0	0	3	0	0
1	57982191	.	A	C	9	7	16	0	1	17	0	0
1	59756998	.	A	G	12	4	16	0	0	16	0	0
1	59913367	.	A	G	41	20	61	0	1	62	0	0
1	60517747	.	A	G	54	19	73	0	12	85	0	0
1	63156443	.	A	G	3	3	6	0	0	6	0	0
1	66711873	.	A	G	104	42	146	2	7	155	0	0
1	86275650	.	T	C	26	2	28	0	3	31	0	0
1	86275689	.	T	C	35	6	41	1	7	49	0	0
1	86276528	.	T	C	12	11	23	0	1	24	0	0
1	88187289	.	A	G	1	3	4	0	0	4	0	0
1	88187311	.	C	T	6	2	8	0	1	9	0	0
1	88187766	.	G	A	7	3	10	0	0	10	0	0
1	88189031	.	G	A	1	2	3	0	0	3	0	0
1	88189404	.	C	T	2	2	4	0	0	4	0	0
1	88189435	.	G	C	4	2	6	0	0	6	0	0
1	88189462	.	G	A	3	4	7	0	0	7	0	0
1	88189611	.	A	G	5	2	7	0	0	7	0	0
1	88189641	.	G	C	3	2	5	0	0	5	0	0
1	88189707	.	C	T	1	3	4	0	0	4	0	0
1	88189910	.	T	C	2	4	6	0	0	6	0	0
1	88189938	.	C	A	2	4	6	0	0	6	0	0
1	88190781	.	C	T	2	2	4	0	0	4	0	0
1	88191237	.	A	C	20	45	65	0	2	67	0	0
1	88191281	.	A	G	62	10	72	0	3	75	0	0
1	88191320	.	C	T	12	40	52	0	1	53	0	0
1	88191468	.	C	G	5	46	51	0	0	51	0	0
1	88191706	.	G	A	33	13	46	0	1	47	0	0
1	88191710	.	T	C	17	29	46	0	0	46	0	0
1	88191744	.	C	A	38	6	44	0	1	45	0	0
1	88191864	.	G	T	44	9	53	0	1	54	0	0
1	88192008	.	C	T	38	9	47	0	6	53	0	0
1	88192048	.	G	C	12	29	41	0	3	44	0	0
1	88192098	.	G	A	60	9	69	0	1	70	0	0
1	88192180	.	G	T	56	7	63	0	1	64	0	0
1	88192184	.	T	A	54	6	60	0	1	61	0	0
1	88192243	.	A	G	5	43	48	0	1	49	0	0
1	88192700	.	G	A	10	30	40	1	1	42	0	0
1	88192756	.	G	A	8	42	50	0	1	51	0	0
1	88192980	.	A	G	5	30	35	1	2	38	0	0
1	88193031	.	C	G	15	13	28	2	0	30	0	0
1	88193194	.	C	T	4	5	9	5	1	15	0	0
1	88193568	.	A	C	1	5	6	35	0	41	0	0
1	88193917	.	G	A	10	13	23	21	2	46	0	0
1	88194314	.	C	A	32	9	41	3	2	46	0	0
1	88197053	.	T	C	9	19	28	0	0	28	0	0
1	88197991	.	A	G	10	42	52	0	1	53	0	0
1	88200452	.	A	G	3	44	47	0	1	48	0	0
1	88200670	.	G	A	2	11	13	0	0	13	0	0
1	88200718	.	C	A	2	9	11	0	0	11	0	0
1	88200832	.	C	T	7	5	12	0	0	12	0	0
1	88202772	.	A	T	23	2	25	3	1	29	0	0
1	88204960	.	T	C	3	26	29	5	0	34	0	0
1	91223819	.	T	G	3	2	5	0	0	5	0	0
1	95426538	.	A	G	2	1	3	5	2	10	0	0
1	100210722	.	C	T	0	2	2	0	1	3	0	0
1	125321091	.	T	C	120	146	266	0	6	272	0	0
1	131954455	.	T	C	8	2	10	0	0	10	0	0
1	133065748	.	A	G	34	5	39	0	1	40	0	0
1	134226803	.	A	G	3	3	6	0	1	7	0	0
1	134677984	.	A	G	5	1	6	0	2	8	0	0
1	135160587	.	A	G	1	4	5	2	0	7	0	0
1	152713324	.	G	A	16	6	22	0	9	31	0	0
1	156255182	.	T	C	4	12	16	0	0	16	0	0
1	156255535	.	T	C	16	3	19	0	1	20	0	0
1	156255601	.	T	C	6	3	9	0	1	10	0	0
1	156468974	.	G	A	2	2	4	0	0	4	0	0
1	159173562	.	C	T	4	2	6	0	0	6	0	0
1	160835343	.	T	C	5	2	7	0	0	7	0	0
1	165058785	.	T	C	2	2	4	0	0	4	0	0
1	178780229	.	T	C	5	5	10	0	0	10	0	0
1	180923652	.	T	C	18	3	21	0	0	21	0	0
1	180924020	.	T	C	18	6	24	0	0	24	0	0
1	183190594	.	A	G	9	5	14	0	0	14	0	0
10	33865297	.	C	A	4	3	7	0	0	7	0	0
10	49118584	.	T	C	14	8	22	0	0	22	0	0
10	49118640	.	T	C	9	4	13	0	0	13	0	0
10	49148872	.	T	C	5	33	38	0	1	39	0	0
10	49148885	.	T	C	7	29	36	0	0	36	0	0
10	57383221	.	A	G	1	2	3	0	0	3	0	0
10	62645542	.	T	C	2	2	4	0	0	4	0	0
10	82486401	.	T	C	18	5	23	0	0	23	0	0
10	82486613	.	T	C	21	6	27	0	0	27	0	0
10	85495589	.	C	T	9	2	11	0	1	12	0	0
10	86524792	.	A	G	3	2	5	0	0	5	0	0
10	87927695	.	T	C	2	4	6	0	0	6	0	0
10	90934017	.	A	G	5	2	7	0	0	7	0	0
10	90934018	.	A	G	5	2	7	0	0	7	0	0
10	93801926	.	T	C	7	2	9	0	0	9	0	0
10	94057224	.	A	G	12	3	15	0	1	16	0	0
10	98945717	.	G	A	2	2	4	0	0	4	0	0
10	120618929	.	A	G	9	2	11	0	0	11	0	0
10	126903751	.	T	C	68	16	84	0	6	90	0	0
10	128033260	.	A	G	2	2	4	0	0	4	0	0
11	3077575	.	C	A	15	3	18	41	1	60	0	0
11	3100439	.	T	C	1	2	3	0	0	3	0	0
11	4091399	.	T	C	12	2	14	0	1	15	0	0
11	5919668	.	A	T	8	2	10	0	3	13	0	0
11	19670767	.	C	T	1	4	5	2	0	7	0	0
11	20178347	.	T	C	17	2	19	0	0	19	0	0
11	20178606	.	T	C	10	4	14	0	0	14	0	0
11	30051812	.	T	C	15	6	21	0	2	23	0	0
11	43572939	.	A	G	5	5	10	0	0	10	0	0
11	43573028	.	A	G	3	3	6	0	0	6	0	0
11	43574343	.	A	G	3	1	4	0	1	5	0	0
11	46163470	.	T	C	105	493	598	0	10	608	0	0
11	48643968	.	T	G	0	2	2	2	1	5	0	0
11	48836577	.	C	T	7	2	9	0	0	9	0	0
11	51646962	.	T	A	7	2	9	0	0	9	0	0
11	54730814	.	T	C	13	2	15	0	2	17	0	0
11	58218094	.	T	C	3	2	5	0	0	5	0	0
11	66955493	.	A	G	13	2	15	0	1	16	0	0
11	69674128	.	A	G	11	10	21	0	0	21	0	0
11	69738198	.	A	C	12	1	13	0	6	19	0	0
11	69738201	.	T	C	12	4	16	0	3	19	0	0
11	69925876	.	A	G	6	2	8	0	0	8	0	0
11	69927869	.	A	G	1	3	4	0	0	4	0	0
11	75067258	.	T	C	25	6	31	0	1	32	0	0
11	77426880	.	T	C	57	13	70	0	1	71	0	0
11	78187443	.	A	G	4	3	7	0	0	7	0	0
11	82854282	.	A	G	4	3	7	0	0	7	0	0
11	82854486	.	A	G	5	2	7	0	0	7	0	0
11	87014114	.	A	G	10	5	15	0	1	16	0	0
11	94431300	.	T	C	7	2	9	0	0	9	0	0
11	94431502	.	T	C	13	4	17	0	1	18	0	0
11	94431842	.	T	C	11	3	14	0	0	14	0	0
11	95938019	.	A	G	8	2	10	0	0	10	0	0
11	97535690	.	T	C	14	2	16	0	0	16	0	0
11	97536428	.	T	C	22	3	25	0	0	25	0	0
11	98736061	.	A	G	10	2	12	0	1	13	0	0
11	98864919	.	A	T	4	2	6	0	0	6	0	0
11	99569239	.	A	G	1	2	3	0	0	3	0	0
11	100488792	.	T	C	6	5	11	0	0	11	0	0
11	101089557	.	T	C	16	5	21	0	0	21	0	0
11	101089802	.	T	C	7	13	20	0	0	20	0	0
11	115420857	.	T	C	8	2	10	0	0	10	0	0
11	116471963	.	T	C	7	24	31	0	1	32	0	0
11	117253070	.	C	T	6	2	8	0	1	9	0	0
11	119337017	.	C	T	2	2	4	0	0	4	0	0
12	3454168	.	A	G	34	9	43	12	0	55	0	0
12	3454248	.	A	G	17	47	64	13	4	81	0	0
12	4287886	.	T	C	3	2	5	0	0	5	0	0
12	4287896	.	T	C	2	2	4	0	0	4	0	0
12	4877258	.	T	A	2	2	4	0	0	4	0	0
12	4877260	.	T	A	2	2	4	0	0	4	0	0
12	15778570	.	T	C	1	2	3	0	0	3	0	0
12	17479686	.	A	G	22	5	27	0	0	27	0	0
12	17479809	.	A	G	9	28	37	0	1	38	0	0
12	46747117	.	T	C	39	14	53	0	1	54	0	0
12	54719070	.	T	C	24	4	28	0	0	28	0	0
12	54719142	.	T	C	31	6	37	0	0	37	0	0
12	65091228	.	A	G	2	2	4	0	0	4	0	0
12	65113982	.	T	C	10	2	12	0	0	12	0	0
12	69244102	.	A	G	13	7	20	0	0	20	0	0
12	71041403	.	A	G	3	27	30	0	0	30	0	0
12	73975614	.	A	G	4	5	9	0	0	9	0	0
12	75677928	.	A	G	4	2	6	3	0	9	0	0
12	75678010	.	C	T	1	2	3	9	1	13	0	0
12	80154594	.	C	T	5	2	7	0	1	8	0	0
12	80155897	.	A	C	9	0	9	0	3	12	0	0
12	80155903	.	A	C	8	2	10	0	2	12	0	0
12	84421785	.	T	C	19	4	23	0	0	23	0	0
12	87467472	.	G	A	2	3	5	4	1	10	0	0
12	91605436	.	T	C	10	4	14	0	0	14	0	0
12	100843647	.	T	C	12	2	14	0	0	14	0	0
12	101886131	.	T	C	25	3	28	0	1	29	0	0
12	101887890	.	T	C	17	7	24	0	0	24	0	0
12	102752010	.	G	T	10	1	11	0	1	12	0	0
12	102752012	.	G	T	9	0	9	0	3	12	0	0
13	13534327	.	T	C	2	2	4	0	0	4	0	0
13	14225628	.	T	C	27	10	37	0	1	38	0	0
13	17979133	.	T	C	7	4	11	0	0	11	0	0
13	17979342	.	T	C	10	2	12	0	0	12	0	0
13	21574188	.	T	C	12	2	14	0	1	15	0	0
13	21576650	.	T	C	5	2	7	0	0	7	0	0
13	35059363	.	T	C	1	1	2	0	0	2	0	0
13	59776305	.	A	G	1	2	3	0	0	3	0	0
13	63448526	.	A	G	4	2	6	0	0	6	0	0
13	64437994	.	T	C	19	2	21	0	0	21	0	0
13	67764223	.	T	C	1	1	2	0	2	4	0	0
13	67967727	.	T	C	1	3	4	0	0	4	0	0
13	67967765	.	T	C	5	3	8	0	1	9	0	0
13	67967775	.	T	C	4	4	8	0	0	8	0	0
13	68709476	.	G	T	3	1	4	0	1	5	0	0
13	69962819	.	A	G	6	2	8	0	0	8	0	0
13	78347088	.	T	C	3	1	4	0	8	12	0	0
13	92577452	.	G	A	13	3	16	0	4	20	0	0
13	97594805	.	C	T	1	2	3	0	0	3	0	0
13	103493717	.	T	C	2	1	3	20	1	25	1	0
13	119625401	.	G	T	14	9	23	0	0	23	0	0
14	9647289	.	A	G	66	10	76	0	2	78	0	0
14	10058181	.	A	G	125	39	164	0	4	168	0	0
14	14533725	.	T	C	4	7	11	0	0	12	1	0
14	14533732	.	T	C	9	2	11	0	0	11	0	0
14	20517408	.	T	C	2	4	6	0	0	6	0	0
14	21084509	.	T	G	3	1	4	0	10	14	0	0
14	21846832	.	A	G	14	48	62	0	0	62	0	0
14	21846833	.	A	G	54	9	63	0	1	64	0	0
14	21847779	.	A	G	76	20	96	0	1	97	0	0
14	26382413	.	T	C	5	3	8	0	0	8	0	0
14	29788070	.	T	C	23	4	27	0	2	29	0	0
14	29788078	.	T	C	20	7	27	0	3	30	0	0
14	30541120	.	C	T	5	3	8	0	0	8	0	0
14	32018582	.	A	G	35	14	49	0	0	49	0	0
14	33953440	.	T	C	12	2	14	0	0	14	0	0
14	33953448	.	T	C	11	3	14	0	0	14	0	0
14	36746227	.	C	T	1	0	1	0	2	3	0	0
14	44502722	.	G	T	1	3	4	1	0	5	0	0
14	51013458	.	T	C	12	5	17	0	0	17	0	0
14	51109987	.	A	G	2	4	6	0	0	6	0	0
14	51115833	.	A	G	16	5	21	1	0	22	0	0
14	54532522	.	G	A	3	2	5	7	0	12	0	0
14	55749057	.	A	G	11	2	13	0	0	13	0	0
14	55873478	.	A	G	5	1	6	0	1	7	0	0
14	65291200	.	A	G	17	5	22	0	17	39	0	0
14	75766144	.	A	C	4	1	5	0	4	9	0	0
14	75957159	.	T	C	27	9	36	0	0	36	0	0
14	103584115	.	T	C	21	14	35	0	2	37	0	0
14	121273016	.	A	G	7	6	13	0	0	13	0	0
15	5150309	.	T	C	1	2	3	12	2	17	0	0
15	8187674	.	A	G	5	10	15	0	1	16	0	0
15	8188973	.	A	G	7	6	13	0	3	16	0	0
15	38873138	.	A	G	2	2	4	0	0	4	0	0
15	58695035	.	T	C	12	2	14	0	0	14	0	0
15	66158075	.	T	C	13	3	16	0	0	16	0	0
15	79571382	.	G	A	36	7	43	0	14	57	0	0
15	81799307	.	G	A	26	5	31	0	8	39	0	0
15	81831458	.	A	G	1	2	3	0	0	3	0	0
15	84837093	.	T	C	9	2	11	0	0	11	0	0
15	85742984	.	G	A	6	2	8	0	0	8	0	0
15	87643542	.	T	A	6	2	8	0	3	11	0	0
15	98634993	.	T	C	14	31	45	0	2	47	0	0
15	98731431	.	T	C	26	6	32	0	0	32	0	0
15	98770376	.	T	G	3	0	3	0	2	6	1	0
15	99142536	.	T	C	76	14	90	28	2	120	0	0
15	99626091	.	A	G	13	6	19	0	0	19	0	0
15	102397557	.	C	T	10	4	14	0	3	17	0	0
16	3568554	.	C	A	1	2	3	0	2	5	0	0
16	3680985	.	T	C	14	7	21	0	2	23	0	0
16	4444211	.	T	C	8	2	10	0	0	10	0	0
16	4604755	.	T	C	1	2	3	0	1	4	0	0
16	10891391	.	T	C	6	9	15	0	9	24	0	0
16	13520445	.	A	G	22	8	30	0	0	30	0	0
16	13650548	.	T	C	1	1	2	0	1	3	0	0
16	13651947	.	T	C	19	3	22	0	0	22	0	0
16	16866848	.	A	G	2	3	5	0	0	5	0	0
16	17321752	.	A	G	17	6	23	0	0	23	0	0
16	17335960	.	A	G	11	4	15	0	0	15	0	0
16	18653678	.	A	G	47	11	58	0	3	61	0	0
16	19942498	.	A	G	48	21	69	0	1	70	0	0
16	20363121	.	A	G	7	2	9	0	0	9	0	0
16	30330773	.	T	C	11	4	15	0	0	15	0	0
16	32119150	.	A	G	24	13	37	0	1	38	0	0
16	75398743	.	A	G	5	1	6	0	1	7	0	0
16	81287278	.	C	T	44	30	74	0	3	77	0	0
16	87230813	.	T	C	14	5	19	0	1	20	0	0
16	87230814	.	T	C	16	3	19	0	1	20	0	0
16	87737431	.	T	C	6	14	20	0	0	20	0	0
16	91453021	.	A	G	67	29	96	1	1	98	0	0
16	97658519	.	T	C	4	3	7	0	0	7	0	0
17	9539532	.	C	T	1	2	3	0	1	4	0	0
17	15741073	.	A	G	1	3	4	0	0	4	0	0
17	27721769	.	T	C	17	2	19	0	0	19	0	0
17	29521001	.	A	G	7	4	11	0	0	11	0	0
17	31875349	.	T	C	2	2	4	0	0	4	0	0
17	33037766	.	T	C	21	2	23	0	0	23	0	0
17	33236838	.	C	T	19	2	21	0	1	22	0	0
17	33522804	.	G	A	9	3	12	0	4	16	0	0
17	33552004	.	T	C	13	2	15	0	1	16	0	0
17	33867844	.	G	A	8	0	8	0	2	10	0	0
17	33966501	.	T	C	27	5	32	151	9	192	0	0
17	34147531	.	A	G	25	9	34	0	2	36	0	0
17	40158498	.	T	C	3625	4495	8120	1	190	8655	344	0
17	40159543	.	T	C	34	263	297	0	5	302	0	0
17	45973875	.	T	C	39	77	116	1	16	133	0	0
17	56576451	.	G	T	1	1	2	0	0	2	0	0
17	56901870	.	A	G	5	2	7	0	0	7	0	0
17	95067479	.	T	C	18	13	31	0	0	31	0	0
18	4198498	.	C	T	1	2	3	21	0	24	0	0
18	6792650	.	A	G	25	8	33	0	0	33	0	0
18	6792802	.	A	G	30	3	33	0	1	34	0	0
18	24097917	.	A	G	6	3	9	0	0	9	0	0
18	32233146	.	A	G	15	2	17	0	1	18	0	0
18	32233182	.	A	G	19	3	22	0	0	22	0	0
18	32235930	.	A	G	7	9	16	0	2	18	0	0
18	32235964	.	A	G	10	3	13	0	0	13	0	0
18	32561134	.	A	G	35	10	45	0	1	46	0	0
18	35743341	.	A	G	7	3	10	0	0	10	0	0
18	35807586	.	T	C	80	18	98	0	2	100	0	0
18	37443955	.	A	G	0	2	2	0	1	3	0	0
18	65610148	.	A	G	3	6	9	0	0	9	0	0
18	65610162	.	A	G	8	2	10	0	0	10	0	0
19	3916452	.	A	G	18	4	22	0	0	22	0	0
19	4325587	.	T	C	1	2	3	0	0	3	0	0
19	4813117	.	T	C	7	3	10	0	1	11	0	0
19	4813159	.	T	C	4	3	7	0	0	7	0	0
19	4813227	.	T	C	6	3	9	0	0	9	0	0
19	5845967	.	T	C	8	2	10	0	0	10	0	0
19	7515480	.	A	G	24	4	28	0	2	30	0	0
19	7937496	.	C	T	1	1	2	1	5	8	0	0
19	7937498	.	G	T	0	1	1	1	6	8	0	0
19	8920351	.	A	G	1	3	4	0	0	4	0	0
19	10223060	.	T	C	37	78	115	0	2	117	0	0
19	10566002	.	A	G	17	2	19	0	1	20	0	0
19	12441626	.	A	G	34	5	39	0	0	39	0	0
19	16731442	.	C	T	1	2	3	0	0	3	0	0
19	21915304	.	T	C	1	1	2	8	1	11	0	0
19	30071086	.	C	T	9	2	11	0	0	11	0	0
19	30071087	.	C	A	9	2	11	0	0	11	0	0
19	34571000	.	A	G	4	3	7	0	1	8	0	0
19	42743827	.	T	C	13	3	16	0	0	16	0	0
19	43429365	.	A	G	6	3	9	0	0	9	0	0
19	43429601	.	A	G	14	9	23	0	0	23	0	0
19	43429753	.	A	G	25	6	31	0	1	32	0	0
19	44674933	.	A	G	3	2	5	0	0	5	0	0
19	44993669	.	T	C	39	7	46	0	1	47	0	0
19	46269407	.	A	G	2	2	4	0	0	4	0	0
19	46583546	.	A	G	6	2	8	0	0	8	0	0
19	47072011	.	A	G	2	2	4	0	0	4	0	0
19	56429663	.	G	T	3	2	5	0	0	5	0	0
2	3461415	.	A	G	1	5	6	0	0	6	0	0
2	6448875	.	C	T	0	5	5	0	3	8	0	0
2	6448880	.	G	T	2	1	3	0	4	7	0	0
2	17382085	.	G	C	1	1	2	0	0	2	0	0
2	22478367	.	T	C	0	2	2	9	5	16	0	0
2	25349502	.	A	G	7	3	10	0	2	12	0	0
2	26278314	.	A	G	5	2	7	0	0	7	0	0
2	29664907	.	T	C	2	2	4	0	0	4	0	0
2	29666798	.	T	C	26	4	30	1	1	32	0	0
2	31937444	.	A	G	19	6	25	0	0	25	0	0
2	32196762	.	A	G	61	13	74	0	2	76	0	0
2	73445970	.	T	C	6	2	8	0	0	8	0	0
2	104511430	.	T	C	19	4	23	0	0	23	0	0
2	112185846	.	A	G	5	6	11	0	0	11	0	0
2	112185852	.	A	G	7	4	11	0	0	11	0	0
2	117101207	.	G	T	5	2	7	0	0	7	0	0
2	117101209	.	A	G	4	2	6	0	0	6	0	0
2	120451649	.	A	G	25	3	28	1	1	30	0	0
2	132151800	.	A	G	48	349	397	0	4	402	1	0
2	152114990	.	A	G	10	3	13	0	0	13	0	0
2	152115260	.	A	G	8	2	10	0	0	10	0	0
2	153459246	.	T	C	2	5	7	0	0	7	0	0
2	154379850	.	A	G	33	8	41	0	0	41	0	0
2	155124100	.	T	C	1	2	3	0	0	3	0	0
2	157400030	.	T	C	85	21	106	8	3	117	0	0
2	158199416	.	A	G	2	2	4	0	0	4	0	0
2	158225545	.	A	G	448	61	509	1	5	515	0	0
2	158226873	.	A	G	104	433	537	0	20	557	0	0
2	163309459	.	T	C	3	13	16	0	0	16	0	0
2	164307764	.	A	C	4	2	6	0	1	7	0	0
2	164307770	.	A	C	4	2	6	0	0	6	0	0
2	164953669	.	T	C	46	5	51	0	1	52	0	0
2	164953773	.	T	C	37	8	45	0	2	47	0	0
2	169913325	.	A	G	2	3	5	0	1	6	0	0
2	169913421	.	A	G	5	5	10	1	0	11	0	0
2	174169694	.	A	G	111	23	134	0	4	138	0	0
2	177401086	.	C	T	10	1	11	0	0	11	0	0
2	177401096	.	T	G	22	3	25	0	1	26	0	0
2	179903620	.	T	C	4	2	6	0	0	6	0	0
3	19279149	.	T	C	14	2	16	0	0	16	0	0
3	32636549	.	T	C	13	2	15	0	0	15	0	0
3	40748697	.	A	G	28	6	34	12	3	49	0	0
3	45356192	.	T	C	4	2	6	0	0	6	0	0
3	57551795	.	T	C	2	3	5	0	0	5	0	0
3	57551841	.	T	C	2	3	5	0	0	5	0	0
3	57551908	.	T	C	5	4	9	0	0	9	0	0
3	57553263	.	T	C	3	2	5	0	0	5	0	0
3	57553275	.	T	C	3	3	6	0	0	6	0	0
3	57732626	.	G	A	4	2	6	0	1	7	0	0
3	65461138	.	C	A	12	3	15	0	0	15	0	0
3	65461142	.	C	A	11	3	14	0	0	14	0	0
3	65587492	.	A	G	2	2	4	0	1	5	0	0
3	65866428	.	A	G	5	3	8	0	1	9	0	0
3	75424017	.	A	T	3	3	6	0	0	6	0	0
3	80599593	.	T	C	137	230	367	4	4	376	1	0
3	80613850	.	T	C	25	6	31	0	1	32	0	0
3	80614159	.	T	C	13	13	26	0	2	28	0	0
3	80614215	.	T	C	279	165	444	0	4	448	0	0
3	85823341	.	T	C	2	2	4	33	0	37	0	0
3	88207974	.	A	G	1	2	3	0	0	3	0	0
3	88259584	.	A	G	5	2	7	0	0	7	0	0
3	88544754	.	A	T	0	2	2	0	1	3	0	0
3	96539776	.	A	G	3	24	27	0	2	29	0	0
3	102973406	.	A	G	40	10	50	0	1	51	0	0
3	103187243	.	A	G	12	2	14	0	0	14	0	0
3	104835351	.	A	G	7	7	14	0	0	14	0	0
3	104835352	.	A	G	10	4	14	0	0	14	0	0
3	107238927	.	A	G	9	3	12	0	1	13	0	0
3	107801728	.	G	A	6	2	8	0	0	8	0	0
3	119503477	.	A	G	2	2	4	1	1	6	0	0
3	135112631	.	T	C	62	8	70	0	1	71	0	0
3	138265030	.	A	G	13	5	18	0	1	19	0	0
3	152090772	.	A	G	3	2	5	0	0	5	0	0
3	153973627	.	C	T	8	2	10	0	3	13	0	0
4	21836550	.	A	G	42	5	47	0	0	47	0	0
4	21911886	.	A	G	16	6	22	0	0	22	0	0
4	33019420	.	A	G	92	21	113	0	2	115	0	0
4	33020417	.	A	G	69	80	149	0	3	152	0	0
4	40727083	.	A	T	1	0	1	0	4	6	1	0
4	41025845	.	A	G	13	2	15	0	1	16	0	0
4	41169063	.	T	G	0	2	2	0	1	3	0	0
4	41518514	.	T	C	210	37	247	0	8	255	0	0
4	45377141	.	A	G	3	5	8	0	1	9	0	0
4	45377142	.	A	G	5	4	9	0	1	10	0	0
4	62371673	.	T	C	1	2	3	0	0	3	0	0
4	69844043	.	C	T	3	2	5	10	2	17	0	0
4	82759725	.	T	C	2	2	4	0	0	4	0	0
4	86495344	.	G	T	65	15	80	0	1	81	0	0
4	107665620	.	C	A	5	2	7	0	0	7	0	0
4	107701489	.	A	G	1	2	3	0	0	3	0	0
4	108198313	.	A	G	7	8	15	0	0	15	0	0
4	116410105	.	T	C	11	3	14	0	0	14	0	0
4	118484005	.	A	G	5	24	29	0	0	29	0	0
4	118484020	.	A	G	16	11	27	0	1	28	0	0
4	118484072	.	A	G	14	6	20	0	0	20	0	0
4	119080668	.	T	C	11	4	15	0	3	18	0	0
4	119081410	.	T	C	22	4	26	1	0	27	0	0
4	124838094	.	A	G	5	12	17	0	0	17	0	0
4	125982944	.	A	G	9	8	17	0	0	17	0	0
4	125982950	.	A	G	11	6	17	0	3	20	0	0
4	125982989	.	A	G	5	6	11	0	0	11	0	0
4	125985458	.	A	G	15	2	17	0	0	17	0	0
4	126920377	.	A	G	3	2	5	0	0	5	0	0
4	126920379	.	A	G	3	2	5	0	0	5	0	0
4	131629013	.	C	A	1	2	3	0	0	3	0	0
4	133389520	.	T	C	6	7	13	0	1	14	0	0
4	137987341	.	A	G	81	20	101	0	7	108	0	0
4	137987354	.	A	G	65	29	94	0	2	96	0	0
4	140678472	.	A	G	12	3	15	0	0	15	0	0
4	140678893	.	A	G	19	8	27	2	0	29	0	0
4	141488012	.	T	C	41	11	52	0	2	54	0	0
4	144314687	.	A	G	2	3	5	19	0	24	0	0
4	147907821	.	T	C	7	2	9	0	0	9	0	0
4	148642124	.	T	C	8	3	11	0	1	12	0	0
4	149202654	.	A	G	37	4	41	1	3	45	0	0
4	149203211	.	A	G	29	3	32	0	1	33	0	0
4	149552635	.	T	C	2	6	8	0	0	8	0	0
4	154430593	.	C	A	2	1	3	0	1	4	0	0
4	155705483	.	A	G	29	6	35	0	0	35	0	0
4	155706828	.	A	G	17	4	21	0	1	23	1	0
4	155800382	.	A	G	17	4	21	0	1	22	0	0
4	155800978	.	A	G	10	3	13	0	0	13	0	0
4	156095123	.	A	G	73	40	113	0	2	115	0	0
4	156331969	.	A	G	26	5	31	0	2	33	0	0
5	3680498	.	T	C	2	4	6	0	0	6	0	0
5	22733677	.	T	G	1	2	3	3	0	6	0	0
5	24649635	.	T	C	28	3	31	0	1	32	0	0
5	25430722	.	A	G	11	5	16	0	0	16	0	0
5	25430882	.	A	G	1	2	3	0	0	3	0	0
5	25896042	.	T	C	7	2	9	0	0	9	0	0
5	29658129	.	A	G	2	2	4	0	0	4	0	0
5	31330824	.	T	C	6	3	9	0	0	9	0	0
5	64987810	.	A	T	11	0	11	0	4	15	0	0
5	65605388	.	T	C	42	25	67	0	2	69	0	0
5	65605389	.	T	C	37	28	65	0	3	68	0	0
5	77555578	.	T	C	3	14	17	0	0	17	0	0
5	77555630	.	T	C	2	12	14	0	2	16	0	0
5	101046080	.	A	T	1	2	3	0	0	3	0	0
5	104652843	.	A	G	31	6	37	0	0	37	0	0
5	104652845	.	A	G	31	5	36	0	1	37	0	0
5	107122527	.	C	T	7	2	9	0	1	10	0	0
5	108519128	.	C	A	11	1	12	3	1	16	0	0
5	114866901	.	T	C	3	3	6	0	0	6	0	0
5	115241332	.	T	C	1	2	3	13	0	16	0	0
5	115437301	.	T	C	11	3	14	0	1	15	0	0
5	115565764	.	C	T	2	2	4	0	0	4	0	0
5	121941595	.	A	G	1	2	3	0	0	3	0	0
5	122546590	.	A	G	18	3	21	0	0	21	0	0
5	122872763	.	T	C	12	3	15	0	0	15	0	0
5	122925758	.	C	A	7	0	7	0	3	10	0	0
5	123303207	.	T	C	2	2	4	0	1	5	0	0
5	123386729	.	A	G	19	11	30	0	2	32	0	0
5	123654715	.	T	C	6	2	8	0	0	8	0	0
5	125534541	.	A	G	55	30	85	1	1	87	0	0
5	127641331	.	G	T	8	2	10	0	0	10	0	0
5	129795880	.	A	G	13	2	15	0	0	15	0	0
5	129798517	.	A	G	9	4	13	0	1	14	0	0
5	130014307	.	A	G	62	13	75	0	1	76	0	0
5	135193845	.	A	G	4	1	5	0	2	7	0	0
5	135193855	.	A	G	3	3	6	0	0	6	0	0
5	135402657	.	A	G	0	2	2	0	2	4	0	0
5	135437709	.	T	C	23	8	31	0	3	34	0	0
5	135437715	.	T	C	17	13	30	0	0	30	0	0
5	135665678	.	A	G	1	2	3	0	0	3	0	0
5	136941953	.	A	G	101	27	128	0	2	130	0	0
5	137281595	.	C	T	9	1	10	0	1	11	0	0
5	137281596	.	G	T	9	1	10	0	1	11	0	0
5	137926698	.	T	C	1	2	3	4	0	7	0	0
5	138362836	.	T	C	2	1	3	4	1	8	0	0
5	142655047	.	A	G	74	24	98	0	3	101	0	0
5	142856760	.	T	C	20	4	24	0	1	26	1	0
5	143840226	.	A	G	12	3	15	0	0	15	0	0
5	143883169	.	A	G	1	4	5	0	0	5	0	0
5	150562299	.	T	C	11	2	13	0	0	13	0	0
6	11926090	.	G	A	6	2	8	0	0	8	0	0
6	15438290	.	G	A	11	0	11	0	2	13	0	0
6	15438291	.	G	A	8	2	10	0	1	11	0	0
6	29946501	.	A	G	2	2	4	0	0	4	0	0
6	31489228	.	G	A	1	3	4	0	0	4	0	0
6	31492600	.	A	G	19	7	26	0	2	28	0	0
6	31492602	.	A	G	16	10	26	0	1	27	0	0
6	37847782	.	A	G	5	2	7	0	0	7	0	0
6	39312088	.	T	C	20	7	27	0	0	27	0	0
6	39312096	.	T	C	22	4	26	0	1	27	0	0
6	42291298	.	G	C	1	2	3	0	0	3	0	0
6	42291301	.	A	C	1	2	3	0	0	3	0	0
6	49231811	.	T	C	13	2	15	0	0	15	0	0
6	49231812	.	T	C	9	5	14	0	1	15	0	0
6	49233394	.	T	C	17	1	18	0	1	19	0	0
6	54621157	.	C	T	3	1	4	0	1	5	0	0
6	54621158	.	C	T	4	0	4	0	2	6	0	0
6	66517065	.	A	G	2	2	4	0	0	4	0	0
6	66517625	.	A	G	5	10	15	0	0	15	0	0
6	66517635	.	A	G	14	3	17	0	0	17	0	0
6	86393034	.	A	G	4	4	8	0	0	8	0	0
6	86393045	.	A	G	6	3	9	0	0	9	0	0
6	88823144	.	T	C	4	2	6	0	0	6	0	0
6	124787536	.	T	C	1	2	3	0	0	3	0	0
6	125217465	.	A	G	2	2	4	0	0	4	0	0
6	126619121	.	T	C	72	29	101	0	1	102	0	0
6	146012079	.	C	T	13	2	15	0	1	16	0	0
7	3463600	.	A	G	85	25	110	0	4	114	0	0
7	5032211	.	G	C	2	2	4	0	1	5	0	0
7	6969234	.	A	G	39	4	43	0	0	43	0	0
7	12706157	.	A	G	10	2	12	0	0	12	0	0
7	12707548	.	A	G	5	2	7	0	0	7	0	0
7	16605458	.	T	C	10	4	14	0	0	14	0	0
7	16606050	.	T	C	8	2	10	0	0	10	0	0
7	18692952	.	A	T	4	0	4	0	6	10	0	0
7	18873733	.	T	C	8	4	12	0	0	12	0	0
7	18873753	.	T	C	12	4	16	0	0	16	0	0
7	19638449	.	T	A	2	8	10	0	0	10	0	0
7	19638461	.	T	A	5	3	8	0	0	8	0	0
7	23840662	.	G	A	3	12	15	3	0	18	0	0
7	23840986	.	C	A	11	2	13	3	0	16	0	0
7	24900427	.	C	T	1	10	11	0	0	11	0	0
7	26904992	.	A	G	5	4	9	0	0	9	0	0
7	26905060	.	A	G	7	5	12	0	0	12	0	0
7	26962319	.	A	G	1	7	8	0	0	8	0	0
7	27227593	.	T	C	68	10	78	0	2	80	0	0
7	27520956	.	A	G	10	2	12	0	0	12	0	0
7	27582931	.	C	G	1	2	3	20	0	23	0	0
7	45032973	.	T	C	2	7	9	0	0	9	0	0
7	49205135	.	A	G	3	3	6	0	0	6	0	0
7	49206073	.	A	G	3	4	7	0	0	7	0	0
7	58972333	.	T	C	4	2	6	0	0	6	0	0
7	59361249	.	A	C	10	2	12	2	1	15	0	0
7	59524496	.	T	C	6	2	8	26	0	34	0	0
7	79206023	.	A	G	27	9	36	0	2	38	0	0
7	80361800	.	T	C	12	5	17	0	0	17	0	0
7	81107174	.	C	T	6	1	7	0	0	7	0	0
7	81107176	.	C	G	6	1	7	0	0	7	0	0
7	81180352	.	A	G	7	3	10	0	0	10	0	0
7	81522050	.	A	G	4	3	7	0	0	7	0	0
7	83405514	.	T	C	4	0	4	27	2	33	0	0
7	100147939	.	G	A	0	2	2	0	1	3	0	0
7	101730415	.	A	G	6	2	8	0	0	8	0	0
7	110655309	.	T	C	27	15	42	1	0	44	1	0
7	123582103	.	A	G	17	3	20	0	0	20	0	0
7	126853494	.	A	G	29	8	37	0	2	39	0	0
7	126853784	.	A	G	42	8	50	0	2	52	0	0
7	127165579	.	A	G	3	3	6	0	0	6	0	0
7	127384489	.	A	G	2	2	4	0	0	4	0	0
7	127582705	.	A	G	1	3	4	0	0	4	0	0
7	130360893	.	A	T	2	7	9	0	0	9	0	0
7	139716520	.	A	G	6	2	8	0	0	8	0	0
7	140916604	.	A	G	43	8	51	0	1	52	0	0
7	141014395	.	A	G	6	3	9	0	5	14	0	0
7	142207010	.	T	C	25	10	35	0	2	37	0	0
8	4409748	.	C	T	7	1	8	0	2	10	0	0
8	4409750	.	C	T	9	0	9	0	3	12	0	0
8	5690864	.	T	C	1	4	5	7	0	12	0	0
8	14078025	.	T	C	7	4	11	0	1	12	0	0
8	14078031	.	T	C	9	3	12	0	0	12	0	0
8	14140659	.	G	A	31	4	35	0	0	35	0	0
8	14140661	.	A	C	30	4	34	0	0	34	0	0
8	19737779	.	A	G	5	3	8	15	0	23	0	0
8	19737782	.	C	G	5	3	8	15	0	23	0	0
8	19747710	.	G	A	8	2	10	6	1	17	0	0
8	19834807	.	A	T	17	4	21	55	1	77	0	0
8	19834818	.	G	A	13	2	15	33	1	49	0	0
8	20030855	.	G	A	10	3	13	10	1	24	0	0
8	20053692	.	A	C	1	2	3	1	0	4	0	0
8	20157964	.	A	G	2	3	5	38	0	43	0	0
8	20698008	.	A	T	19	6	25	20	1	46	0	0
8	20727130	.	G	A	27	10	37	3	0	40	0	0
8	23429659	.	A	C	4	3	7	0	6	13	0	0
8	26303703	.	T	C	9	2	11	0	0	11	0	0
8	26303777	.	T	C	10	3	13	0	0	13	0	0
8	28676194	.	T	G	1	2	3	0	0	3	0	0
8	42700052	.	A	G	2	2	4	7	1	12	0	0
8	42700133	.	T	G	1	4	5	1	0	6	0	0
8	46606404	.	A	G	1	2	3	0	0	3	0	0
8	46707894	.	T	C	1	2	3	0	1	4	0	0
8	69281145	.	T	C	9	2	11	0	0	11	0	0
8	70023416	.	T	A	1	2	3	3	0	6	0	0
8	70028682	.	T	C	2	2	4	5	0	9	0	0
8	71050149	.	A	G	3	2	5	0	0	5	0	0
8	72977426	.	A	G	20	18	38	0	0	38	0	0
8	84723069	.	T	A	1	2	3	0	2	5	0	0
8	85593313	.	A	G	1	3	4	0	0	4	0	0
8	85684156	.	T	C	9	3	12	0	0	12	0	0
8	95049423	.	A	G	5	2	7	0	1	8	0	0
8	96208687	.	C	A	1	2	3	0	0	3	0	0
8	104986580	.	A	G	1	4	5	0	0	5	0	0
8	104987504	.	A	G	2	3	5	0	0	5	0	0
8	110400054	.	T	C	3	2	5	0	0	5	0	0
8	110817217	.	A	G	23	5	28	0	0	28	0	0
8	111731758	.	T	C	15	3	18	0	0	18	0	0
8	120486932	.	T	C	6	2	8	0	1	9	0	0
8	122379628	.	A	G	1	3	4	0	0	4	0	0
8	123198434	.	T	C	2	4	6	0	0	6	0	0
8	125620861	.	T	C	34	7	41	0	1	42	0	0
8	125620868	.	T	C	36	5	41	0	1	42	0	0
9	3387716	.	A	G	9	5	14	0	1	15	0	0
9	3387771	.	A	G	15	6	21	0	0	21	0	0
9	4313759	.	A	G	6	3	9	0	1	10	0	0
9	4313761	.	A	G	7	3	10	0	0	10	0	0
9	4456006	.	T	C	7	16	23	0	0	23	0	0
9	7836792	.	T	C	6	2	8	0	0	8	0	0
9	8022080	.	T	C	7	3	10	0	0	10	0	0
9	15821586	.	T	C	7	2	9	0	1	10	0	0
9	20512335	.	A	G	6	2	8	0	0	8	0	0
9	20512443	.	A	G	6	2	8	0	0	8	0	0
9	20512857	.	A	G	5	3	8	0	0	8	0	0
9	20515794	.	A	G	2	2	4	0	1	5	0	0
9	20515808	.	A	G	2	3	5	0	0	5	0	0
9	43957544	.	A	G	7	2	9	0	0	9	0	0
9	44322493	.	T	C	4	2	6	0	0	6	0	0
9	44322503	.	T	C	4	2	6	0	0	6	0	0
9	47764621	.	G	A	24	1	25	0	9	34	0	0
9	51913603	.	A	G	2	3	5	0	0	5	0	0
9	57041680	.	A	G	11	2	13	0	0	13	0	0
9	57051592	.	T	C	8	4	12	0	0	12	0	0
9	57697794	.	C	T	1	2	3	0	0	3	0	0
9	57697796	.	G	T	1	0	1	0	3	4	0	0
9	58769494	.	T	C	5	1	6	0	2	8	0	0
9	58769496	.	A	C	5	0	5	0	4	9	0	0
9	65253476	.	A	G	6	3	9	0	0	9	0	0
9	65273907	.	A	G	2	3	5	0	0	5	0	0
9	69924723	.	T	C	5	3	8	0	0	8	0	0
9	79351592	.	T	C	4	3	7	0	0	7	0	0
9	83304875	.	T	C	1	2	3	0	0	3	0	0
9	95939293	.	A	G	30	9	39	0	1	40	0	0
9	108178884	.	G	A	11	2	13	0	0	13	0	0
9	109659532	.	T	G	3	2	5	0	0	5	0	0
9	109659543	.	A	G	3	2	5	0	0	5	0	0
9	109659804	.	T	C	9	2	11	0	0	11	0	0
9	124034058	.	T	G	23	7	30	3	0	33	0	0
X	7774376	.	A	G	5	6	11	0	0	11	0	0
X	7790116	.	A	G	1	2	3	0	0	3	0	0
X	37697716	.	A	G	4	2	6	0	0	6	0	0
X	40743129	.	A	G	12	134	146	0	3	149	0	0
X	40743165	.	A	G	6	4	10	0	0	10	0	0
X	55633003	.	T	C	27	12	39	0	3	42	0	0
X	56429832	.	C	A	24	4	28	0	4	32	0	0
X	60231705	.	A	G	12	11	23	0	0	23	0	0
X	69388256	.	T	C	73	11	84	1	1	86	0	0
X	72774914	.	A	G	3	3	6	0	0	6	0	0
X	72841091	.	T	C	3	2	5	0	0	5	0	0
X	73270255	.	T	C	5	7	12	0	0	12	0	0
X	73270468	.	T	C	9	17	26	0	1	27	0	0
X	80866059	.	A	G	2	2	4	96	0	100	0	0
X	102620158	.	T	C	3	11	14	0	1	15	0	0
X	102620159	.	T	C	2	13	15	0	0	15	0	0
X	102622308	.	A	C	7	2	9	0	0	9	0	0
X	102623385	.	T	C	8	3	11	0	0	11	0	0
X	102623421	.	T	C	5	3	8	0	1	9	0	0
X	106830700	.	T	C	60	8	68	0	0	68	0	0
X	135950573	.	A	G	10	3	13	0	0	13	0	0
X	143107441	.	A	G	8	4	12	0	0	12	0	0
X	145978689	.	A	G	64	11	75	0	1	76	0	0
X	149766871	.	T	C	45	12	57	0	7	64	0	0
X	149767614	.	T	C	101	57	158	2	14	174	0	0
X	159360986	.	A	G	30	7	37	0	0	37	0	0
Y	1016394	.	A	G	13	27	40	0	1	41	0	0
