contig	position	variantID	refAllele	altAllele	refCount	altCount	totalCount	lowMAPQDepth	lowBaseQDepth	rawDepth	otherBases	improperPairs
1	12636422	.	C	T	5	2	7	2	0	9	0	0
1	22031785	.	T	C	5	10	15	0	0	15	0	0
1	22031965	.	T	C	13	3	16	0	0	16	0	0
1	36405381	.	T	C	1	2	3	0	0	3	0	0
1	39695983	.	A	G	2	2	4	0	0	4	0	0
1	39696041	.	A	G	4	2	6	0	0	6	0	0
1	43131596	.	C	G	8	13	21	0	0	21	0	0
1	57982191	.	A	C	16	23	39	0	0	39	0	0
1	59756950	.	A	G	9	2	11	0	1	12	0	0
1	59756998	.	A	G	9	3	12	0	0	12	0	0
1	59913367	.	A	G	80	20	100	0	7	107	0	0
1	60517747	.	A	G	60	30	90	0	8	98	0	0
1	63156443	.	A	G	4	2	6	0	0	6	0	0
1	66711873	.	A	G	124	42	166	0	7	173	0	0
1	74720979	.	T	C	7	2	9	0	0	9	0	0
1	75398649	.	A	G	21	7	28	0	0	28	0	0
1	75398708	.	A	G	3	22	25	0	2	27	0	0
1	86275650	.	T	C	26	6	32	0	1	33	0	0
1	86276528	.	T	C	26	6	32	0	0	32	0	0
1	86836917	.	T	C	0	2	2	8	1	11	0	0
1	88187259	.	T	C	4	2	6	0	1	7	0	0
1	88187311	.	C	T	3	2	5	0	0	5	0	0
1	88188057	.	A	C	1	10	11	0	0	11	0	0
1	88188255	.	C	T	4	1	5	0	1	6	0	0
1	88188277	.	C	G	3	3	6	0	0	6	0	0
1	88188360	.	T	G	1	7	8	0	0	8	0	0
1	88188362	.	C	G	1	7	8	0	0	8	0	0
1	88188444	.	G	C	1	5	6	0	0	6	0	0
1	88189006	.	G	A	1	2	3	0	0	3	0	0
1	88189435	.	G	C	4	2	6	0	0	6	0	0
1	88189462	.	G	A	3	2	5	0	0	5	0	0
1	88189611	.	A	G	4	2	6	0	0	6	0	0
1	88189685	.	C	A	2	3	5	0	0	5	0	0
1	88190661	.	G	C	2	4	6	0	0	6	0	0
1	88190921	.	C	T	1	10	11	0	0	11	0	0
1	88191237	.	A	C	12	42	54	0	9	63	0	0
1	88191320	.	C	T	12	42	54	0	1	55	0	0
1	88191706	.	G	A	51	13	64	0	2	66	0	0
1	88191710	.	T	C	18	44	62	0	0	62	0	0
1	88191744	.	C	A	44	17	61	0	0	61	0	0
1	88191864	.	G	T	70	19	89	0	3	92	0	0
1	88192008	.	C	T	70	11	81	0	8	89	0	0
1	88192048	.	G	C	15	43	58	0	2	60	0	0
1	88192098	.	G	A	61	15	76	0	1	77	0	0
1	88192180	.	G	T	85	18	103	0	2	105	0	0
1	88192184	.	T	A	84	17	101	0	3	104	0	0
1	88192243	.	A	G	12	40	52	0	0	52	0	0
1	88192700	.	G	A	15	23	38	0	1	39	0	0
1	88192756	.	G	A	17	45	62	0	1	63	0	0
1	88193031	.	C	G	12	22	34	0	0	34	0	0
1	88193194	.	C	T	5	8	13	1	0	14	0	0
1	88193292	.	T	A	1	2	3	7	0	10	0	0
1	88193614	.	C	G	12	2	14	66	0	80	0	0
1	88193917	.	G	A	11	17	28	23	1	52	0	0
1	88194314	.	C	A	57	9	66	5	0	71	0	0
1	88197053	.	T	C	18	33	51	0	1	52	0	0
1	88197991	.	A	G	13	46	59	0	0	59	0	0
1	88197996	.	C	T	5	58	63	0	2	65	0	0
1	88200452	.	A	G	5	44	49	0	4	53	0	0
1	88200832	.	C	T	5	15	20	0	0	20	0	0
1	88202772	.	A	T	29	9	38	2	1	41	0	0
1	88205286	.	A	T	8	3	11	6	2	19	0	0
1	95426538	.	A	G	2	3	5	4	0	9	0	0
1	133065748	.	A	G	42	8	50	0	0	50	0	0
1	153636565	.	G	A	4	0	4	0	2	6	0	0
1	153636567	.	G	A	4	1	5	0	1	6	0	0
1	156194054	.	C	A	13	3	16	20	1	37	0	0
1	156255601	.	T	C	6	2	8	0	0	8	0	0
1	156351897	.	T	C	4	1	5	20	1	26	0	0
1	171151897	.	T	C	1	2	3	0	0	3	0	0
1	178779916	.	T	C	8	6	14	0	0	14	0	0
1	178780229	.	T	C	12	10	22	0	1	23	0	0
1	180923662	.	T	C	23	3	26	0	0	26	0	0
1	180924020	.	T	C	26	9	35	0	0	35	0	0
1	183190594	.	A	G	15	6	21	0	0	21	0	0
1	187081766	.	T	C	7	3	10	0	0	10	0	0
10	7524278	.	T	C	7	2	9	0	0	9	0	0
10	18000875	.	A	G	13	3	16	0	0	16	0	0
10	33791335	.	A	G	9	2	11	0	0	11	0	0
10	43400614	.	A	C	1	2	3	0	0	3	0	0
10	43414676	.	T	C	1	2	3	0	0	3	0	0
10	45752162	.	G	A	10	5	15	22	1	38	0	0
10	49118584	.	T	C	4	11	15	0	0	15	0	0
10	49118640	.	T	C	15	8	23	0	1	24	0	0
10	49148885	.	T	C	7	29	36	0	0	36	0	0
10	57391874	.	C	T	17	4	21	0	1	22	0	0
10	62645542	.	T	C	2	4	6	0	0	6	0	0
10	80522269	.	T	C	9	3	12	0	0	12	0	0
10	82486401	.	T	C	19	3	22	0	0	22	0	0
10	82486613	.	T	C	9	5	14	0	0	14	0	0
10	93801926	.	T	C	5	4	9	0	0	9	0	0
10	93978692	.	A	T	1	1	2	0	2	4	0	0
10	94057224	.	A	G	23	9	32	0	0	32	0	0
10	126903751	.	T	C	103	19	122	0	1	124	1	0
10	127581290	.	A	G	3	2	5	0	0	5	0	0
10	128032764	.	A	G	4	3	7	1	0	8	0	0
11	3077575	.	C	A	9	2	11	39	2	52	0	0
11	3103492	.	T	C	12	2	14	0	2	16	0	0
11	3407568	.	A	G	13	3	16	0	0	16	0	0
11	3407590	.	A	G	10	5	15	0	0	15	0	0
11	3850994	.	A	G	21	7	28	0	0	28	0	0
11	20178606	.	T	C	21	7	28	0	0	28	0	0
11	43572939	.	A	G	5	3	8	0	0	8	0	0
11	43573028	.	A	G	6	3	9	0	0	9	0	0
11	45821425	.	T	C	16	4	20	0	0	20	0	0
11	46163470	.	T	C	112	547	659	0	8	667	0	0
11	54730814	.	T	C	14	2	16	0	0	16	0	0
11	62032236	.	A	G	1	2	3	0	0	3	0	0
11	66955493	.	A	G	14	2	16	0	0	16	0	0
11	69674128	.	A	G	16	5	21	0	0	21	0	0
11	69922901	.	A	G	4	4	8	0	0	8	0	0
11	69922910	.	A	G	10	1	11	0	1	12	0	0
11	69937302	.	A	G	11	4	15	0	0	15	0	0
11	69937304	.	A	G	13	2	15	0	0	15	0	0
11	74747553	.	T	C	1	3	4	0	0	4	0	0
11	75067258	.	T	C	27	5	32	0	0	32	0	0
11	77426880	.	T	C	49	12	61	0	1	62	0	0
11	77873983	.	C	G	13	3	16	0	10	26	0	0
11	78186104	.	A	G	6	3	9	0	1	10	0	0
11	82853392	.	A	G	1	2	3	0	0	3	0	0
11	82853481	.	A	G	2	2	4	0	0	4	0	0
11	83674148	.	C	T	4	3	7	0	0	7	0	0
11	87014103	.	A	G	15	4	19	0	2	21	0	0
11	87014114	.	A	G	15	5	20	0	0	20	0	0
11	94299330	.	C	T	5	0	5	0	3	8	0	0
11	94299332	.	C	T	6	3	9	0	0	9	0	0
11	94431300	.	T	C	7	1	8	0	0	8	0	0
11	94431318	.	T	C	6	3	9	0	0	9	0	0
11	95962333	.	T	C	4	2	6	0	0	6	0	0
11	97535375	.	T	C	15	3	18	0	0	18	0	0
11	97535690	.	T	C	12	4	16	0	1	17	0	0
11	97729585	.	C	A	15	2	17	0	0	17	0	0
11	97978020	.	A	G	3	5	8	0	0	8	0	0
11	100488699	.	T	C	9	2	11	0	0	11	0	0
11	100488792	.	T	C	9	7	16	0	0	16	0	0
11	101089557	.	T	C	16	4	20	0	0	20	0	0
11	101089802	.	T	C	10	7	17	0	1	18	0	0
11	115915085	.	T	C	13	2	15	0	0	15	0	0
11	116245085	.	T	C	3	3	6	0	0	6	0	0
11	116303813	.	T	C	3	2	5	0	0	5	0	0
11	116471963	.	T	C	15	37	52	0	6	58	0	0
12	3454168	.	A	G	43	6	49	10	1	60	0	0
12	3454248	.	A	G	18	47	65	12	9	86	0	0
12	17479686	.	A	G	17	4	21	0	1	22	0	0
12	17479809	.	A	G	9	15	24	0	0	24	0	0
12	46747117	.	T	C	37	15	52	0	0	52	0	0
12	54718540	.	T	C	24	6	30	0	1	31	0	0
12	54719070	.	T	C	34	14	48	0	0	48	0	0
12	54719142	.	T	C	44	7	51	0	1	52	0	0
12	65099888	.	T	C	1	1	2	0	2	4	0	0
12	65113982	.	T	C	5	2	7	0	0	7	0	0
12	69244102	.	A	G	21	10	31	0	1	32	0	0
12	69347175	.	A	G	2	2	4	0	0	4	0	0
12	71041403	.	A	G	4	37	41	0	1	42	0	0
12	71041945	.	A	G	31	5	36	0	0	36	0	0
12	78731515	.	T	A	7	2	9	0	4	13	0	0
12	78887986	.	T	C	7	2	9	0	0	9	0	0
12	84809097	.	T	C	1	3	4	0	0	4	0	0
12	84969484	.	T	C	3	2	5	0	0	5	0	0
12	84969788	.	T	C	2	2	4	0	0	4	0	0
12	87467472	.	G	A	2	3	5	2	0	7	0	0
12	91605436	.	T	C	9	2	11	0	0	11	0	0
12	98761274	.	T	C	7	2	9	0	0	9	0	0
12	100843647	.	T	C	13	2	15	0	0	15	0	0
12	101886131	.	T	C	19	5	24	0	0	24	0	0
12	103381641	.	C	T	3	2	5	0	0	5	0	0
12	103381643	.	G	T	4	1	5	0	1	6	0	0
12	108993691	.	A	G	16	4	20	0	1	21	0	0
12	109511197	.	C	A	6	0	6	0	12	18	0	0
12	109706996	.	A	G	4	2	6	0	0	6	0	0
13	14225628	.	T	C	36	10	46	0	0	46	0	0
13	14226674	.	T	C	60	5	65	0	0	65	0	0
13	14228102	.	T	C	26	4	30	0	4	34	0	0
13	15989053	.	T	C	1	2	3	0	1	4	0	0
13	17978887	.	T	C	4	2	6	0	0	6	0	0
13	17979133	.	T	C	8	3	11	0	1	12	0	0
13	21571267	.	G	T	2	2	4	0	1	5	0	0
13	21571270	.	C	T	2	2	4	0	1	5	0	0
13	21574169	.	T	C	12	5	17	0	0	17	0	0
13	21574188	.	T	C	12	2	14	0	0	14	0	0
13	55745486	.	G	A	6	3	9	0	2	11	0	0
13	55745493	.	G	A	4	1	5	0	2	7	0	0
13	64438124	.	T	C	11	3	14	0	0	14	0	0
13	80309695	.	A	C	1	2	3	2	1	6	0	0
13	89805164	.	T	A	8	2	10	0	0	10	0	0
13	89805165	.	A	T	11	2	13	0	0	13	0	0
13	119625401	.	G	T	20	16	36	0	0	36	0	0
13	120071842	.	A	G	21	2	23	0	0	23	0	0
14	9647289	.	A	G	96	18	114	0	3	117	0	0
14	10058181	.	A	G	167	40	207	0	3	210	0	0
14	21846832	.	A	G	17	45	62	0	2	64	0	0
14	21846833	.	A	G	51	12	63	0	0	63	0	0
14	21847779	.	A	G	92	26	118	0	3	121	0	0
14	26381874	.	T	C	6	2	8	1	0	9	0	0
14	26382413	.	T	C	5	3	8	0	0	8	0	0
14	27205403	.	A	G	9	2	11	0	0	11	0	0
14	29788070	.	T	C	27	7	34	0	1	35	0	0
14	29788078	.	T	C	18	14	32	0	0	32	0	0
14	31228237	.	A	G	3	2	5	0	0	5	0	0
14	32018582	.	A	G	30	10	40	0	2	42	0	0
14	32300088	.	A	G	8	1	9	0	3	12	0	0
14	40781077	.	T	C	1	2	3	0	0	3	0	0
14	48646502	.	T	C	0	2	2	0	1	3	0	0
14	51013458	.	T	C	11	2	13	0	0	13	0	0
14	51014498	.	T	C	15	3	18	0	0	18	0	0
14	51109987	.	A	G	4	3	7	0	0	7	0	0
14	54928195	.	G	A	1	2	3	0	0	3	0	0
14	60451314	.	T	C	3	2	5	0	0	5	0	0
14	61602660	.	A	T	2	2	4	0	0	4	0	0
14	62930650	.	C	T	4	1	5	0	1	6	0	0
14	65291200	.	A	G	31	8	39	0	33	72	0	0
14	75957159	.	T	C	32	13	45	0	1	46	0	0
14	103584115	.	T	C	22	15	37	0	0	37	0	0
14	121273016	.	A	G	7	7	14	0	0	14	0	0
15	5150549	.	A	G	1	3	4	1	0	5	0	0
15	8187674	.	A	G	8	7	15	0	0	15	0	0
15	8187696	.	A	G	13	3	16	0	0	16	0	0
15	8188973	.	A	G	2	6	8	0	2	10	0	0
15	54616316	.	G	A	5	2	7	0	3	10	0	0
15	55118295	.	A	G	20	4	24	0	0	24	0	0
15	58695035	.	T	C	28	5	33	0	0	33	0	0
15	66158075	.	T	C	11	5	16	0	1	17	0	0
15	68965365	.	G	A	4	2	6	0	0	6	0	0
15	68973014	.	C	A	3	3	6	0	3	9	0	0
15	76248265	.	A	G	2	2	4	0	0	4	0	0
15	76601407	.	A	G	1	2	3	0	0	3	0	0
15	79571382	.	G	A	42	6	48	0	9	57	0	0
15	81799307	.	G	A	43	12	55	0	12	67	0	0
15	83542303	.	T	C	2	2	4	0	0	4	0	0
15	89357811	.	G	A	3	3	6	0	1	7	0	0
15	93172792	.	T	A	6	0	6	0	0	6	0	0
15	98634993	.	T	C	27	41	68	0	2	70	0	0
15	98731431	.	T	C	30	7	37	0	0	37	0	0
15	98932415	.	C	T	2	3	5	256	1	262	0	0
15	99142536	.	T	C	116	20	136	24	0	160	0	0
15	99626091	.	A	G	11	3	14	0	0	14	0	0
16	3680985	.	T	C	20	4	24	0	0	24	0	0
16	4105409	.	C	T	7	3	10	0	0	10	0	0
16	4844012	.	T	C	1	2	3	0	0	3	0	0
16	13520445	.	A	G	26	15	41	0	0	41	0	0
16	13520501	.	A	G	17	3	20	0	1	21	0	0
16	13651947	.	T	C	32	4	36	0	2	38	0	0
16	13767397	.	A	G	19	3	22	0	0	22	0	0
16	16866848	.	A	G	1	3	4	0	0	4	0	0
16	17321752	.	A	G	10	4	14	0	0	14	0	0
16	18653678	.	A	G	59	13	72	0	0	72	0	0
16	19942498	.	A	G	37	24	61	0	1	62	0	0
16	20363153	.	A	G	6	5	11	0	0	11	0	0
16	30330773	.	T	C	14	4	18	0	0	18	0	0
16	32119150	.	A	G	28	13	41	0	0	41	0	0
16	35747215	.	T	C	2	2	4	0	0	4	0	0
16	43691361	.	T	C	3	4	7	0	0	7	0	0
16	44042800	.	C	T	7	2	9	0	2	11	0	0
16	75398743	.	A	G	7	3	10	0	0	10	0	0
16	81393075	.	C	T	5	2	7	0	0	7	0	0
16	87230813	.	T	C	12	5	17	0	0	17	0	0
16	87230814	.	T	C	14	2	16	0	1	17	0	0
16	87737431	.	T	C	4	14	18	0	0	18	0	0
16	91287619	.	A	G	4	1	5	0	1	6	0	0
16	91453021	.	A	G	86	13	99	0	0	99	0	0
16	97658408	.	T	C	3	3	6	0	0	6	0	0
17	3127588	.	T	G	12	2	14	24	0	38	0	0
17	9539467	.	T	A	1	3	4	0	0	4	0	0
17	13238450	.	A	G	9	3	12	7	0	19	0	0
17	15695826	.	T	C	1	3	4	0	0	4	0	0
17	15741073	.	A	G	5	2	7	0	0	7	0	0
17	17565922	.	T	C	8	2	10	206	0	216	0	0
17	24635698	.	A	G	6	3	9	0	1	10	0	0
17	24635786	.	A	G	7	2	9	0	0	9	0	0
17	24941898	.	T	C	10	2	12	0	0	12	0	0
17	26875714	.	T	G	5	3	8	0	3	11	0	0
17	26916583	.	A	G	5	2	7	0	0	7	0	0
17	27721769	.	T	C	16	2	18	0	0	18	0	0
17	27814786	.	T	C	2	2	4	0	0	4	0	0
17	29521001	.	A	G	9	7	16	0	1	17	0	0
17	33037804	.	T	C	21	5	26	0	0	26	0	0
17	33552004	.	T	C	13	4	17	0	1	18	0	0
17	33867517	.	T	C	7	3	10	0	1	11	0	0
17	34147531	.	A	G	26	4	30	0	1	31	0	0
17	36580955	.	T	C	3	2	5	0	0	5	0	0
17	40158498	.	T	C	3897	5424	9321	2	162	9923	438	0
17	40159543	.	T	C	33	205	238	0	2	240	0	0
17	45973875	.	T	C	47	112	159	0	11	170	0	0
17	47996812	.	T	C	1	1	2	0	1	3	0	0
17	56736196	.	C	G	2	1	3	0	1	4	0	0
17	95067479	.	T	C	21	15	36	0	2	38	0	0
17	95183909	.	T	A	2	2	4	0	0	4	0	0
18	5593495	.	A	C	3	2	5	0	0	5	0	0
18	6792802	.	A	G	30	11	41	0	1	42	0	0
18	24097662	.	A	C	7	2	9	0	1	10	0	0
18	24097663	.	A	C	7	1	8	0	2	10	0	0
18	32235930	.	A	G	3	3	6	0	0	6	0	0
18	32235964	.	A	G	8	2	10	0	0	10	0	0
18	32235981	.	A	G	9	2	11	0	0	11	0	0
18	32236019	.	A	G	6	4	10	0	1	11	0	0
18	32561134	.	A	G	35	5	40	0	1	41	0	0
18	35807586	.	T	C	101	13	114	0	0	114	0	0
18	37444052	.	A	G	1	1	2	0	0	2	0	0
18	61328635	.	T	C	4	2	6	0	0	6	0	0
18	62794853	.	A	G	6	2	8	0	0	8	0	0
18	65610148	.	A	G	4	3	7	0	0	7	0	0
18	65610199	.	A	G	5	2	7	0	0	7	0	0
19	3917362	.	A	G	8	3	11	0	0	11	0	0
19	4324082	.	T	C	1	2	3	0	0	3	0	0
19	4813117	.	T	C	6	4	10	0	0	10	0	0
19	6392304	.	A	T	30	29	59	1	3	63	0	0
19	6895771	.	T	C	7	2	9	0	0	9	0	0
19	6895783	.	T	C	6	3	9	0	0	9	0	0
19	7515480	.	A	G	34	8	42	0	0	42	0	0
19	10223060	.	T	C	35	78	113	0	1	114	0	0
19	10494226	.	T	C	2	2	4	0	0	4	0	0
19	10607183	.	G	A	7	3	10	0	0	10	0	0
19	10886122	.	A	G	4	2	6	0	0	6	0	0
19	10886159	.	A	G	4	3	7	0	0	7	0	0
19	12441626	.	A	G	40	7	47	0	1	48	0	0
19	16244498	.	G	A	0	2	2	0	1	3	0	0
19	23597387	.	T	C	5	2	7	50	1	58	0	0
19	38776795	.	T	C	8	2	10	0	0	10	0	0
19	41818939	.	A	G	22	3	25	0	0	25	0	0
19	43429365	.	A	G	14	3	17	0	1	18	0	0
19	43429601	.	A	G	17	21	38	0	1	39	0	0
19	43429686	.	A	G	31	6	37	0	1	38	0	0
19	43429753	.	A	G	39	8	47	0	2	49	0	0
19	44993669	.	T	C	53	10	63	0	1	64	0	0
19	46269419	.	A	G	4	2	6	0	0	6	0	0
2	3461293	.	A	G	1	2	3	0	0	3	0	0
2	22477570	.	T	C	0	1	1	5	2	8	0	0
2	22478588	.	G	A	0	3	3	2	1	6	0	0
2	26846568	.	T	C	2	2	4	0	0	4	0	0
2	27153718	.	T	C	9	3	12	0	0	12	0	0
2	28396998	.	A	G	6	3	9	0	0	9	0	0
2	29921460	.	T	A	8	2	10	0	1	11	0	0
2	30920396	.	T	C	26	4	30	0	0	30	0	0
2	32173436	.	T	C	3	2	5	0	0	5	0	0
2	32196762	.	A	G	75	11	86	0	1	87	0	0
2	35050806	.	T	C	5	2	7	0	0	7	0	0
2	37470941	.	G	A	5	2	7	0	1	8	0	0
2	40445910	.	G	T	1	4	5	4	1	10	0	0
2	40445978	.	T	C	1	5	6	3	0	9	0	0
2	91043632	.	A	G	45	15	60	0	1	61	0	0
2	112185846	.	A	G	4	3	7	0	0	7	0	0
2	112186208	.	A	G	8	4	12	0	0	12	0	0
2	112186230	.	A	G	12	2	14	0	0	14	0	0
2	118700801	.	A	G	11	10	21	0	0	21	0	0
2	119481395	.	T	C	8	2	10	0	0	10	0	0
2	120451649	.	A	G	37	6	43	1	0	44	0	0
2	121015462	.	A	G	8	2	10	0	0	10	0	0
2	130715901	.	T	C	4	2	6	0	0	6	0	0
2	132151800	.	A	G	69	364	433	0	4	437	0	0
2	144382358	.	A	G	19	3	22	0	1	23	0	0
2	152114942	.	A	G	4	9	13	0	1	14	0	0
2	153108264	.	A	G	17	2	19	0	0	19	0	0
2	153459246	.	T	C	3	2	5	0	0	5	0	0
2	154379850	.	A	G	35	11	46	0	2	48	0	0
2	157400030	.	T	C	121	26	147	7	2	157	1	0
2	158225545	.	A	G	360	64	424	0	2	427	1	0
2	158226873	.	A	G	88	396	484	0	16	500	0	0
2	158438117	.	T	C	9	2	11	0	0	11	0	0
2	158438124	.	T	C	7	2	9	0	0	9	0	0
2	163309459	.	T	C	12	10	22	0	0	22	0	0
2	164635687	.	T	C	1	5	6	0	0	6	0	0
2	164761458	.	A	G	6	2	8	0	0	8	0	0
2	164953669	.	T	C	52	7	59	0	0	59	0	0
2	164953773	.	T	C	40	11	51	0	1	52	0	0
2	166408278	.	A	G	13	4	17	0	0	17	0	0
2	168057882	.	T	C	3	2	5	0	0	5	0	0
2	169913325	.	A	G	5	2	7	0	0	7	0	0
2	174169694	.	A	G	111	16	127	0	3	130	0	0
3	26385911	.	T	C	11	3	14	0	2	16	0	0
3	32636549	.	T	C	10	3	13	0	0	13	0	0
3	36146643	.	A	G	4	2	6	1	0	7	0	0
3	40748697	.	A	G	38	15	53	16	0	69	0	0
3	45388130	.	A	G	19	3	22	0	0	22	0	0
3	53599973	.	A	T	2	3	5	7	0	12	0	0
3	65866372	.	A	G	3	3	6	0	0	6	0	0
3	80599593	.	T	C	145	249	394	5	4	403	0	0
3	80613850	.	T	C	23	5	28	0	0	28	0	0
3	80614159	.	T	C	14	17	31	0	0	31	0	0
3	80614215	.	T	C	350	148	498	0	5	503	0	0
3	85463819	.	T	C	2	4	6	0	0	6	0	0
3	88259542	.	A	G	11	3	14	0	0	14	0	0
3	89675221	.	T	C	15	3	18	0	0	18	0	0
3	90389599	.	A	G	1	2	3	0	0	3	0	0
3	92335373	.	G	T	2	1	3	1	1	5	0	0
3	95095436	.	T	C	14	3	17	0	0	17	0	0
3	96539776	.	A	G	8	29	37	0	2	39	0	0
3	96540029	.	A	G	39	9	48	0	3	51	0	0
3	101367937	.	C	T	7	2	9	0	1	10	0	0
3	102973406	.	A	G	33	16	49	0	0	49	0	0
3	103187243	.	A	G	24	4	28	0	0	28	0	0
3	104835351	.	A	G	4	4	8	0	1	9	0	0
3	116423212	.	A	G	4	3	7	0	0	7	0	0
3	116427215	.	T	C	3	2	5	0	0	5	0	0
3	121155810	.	G	A	14	3	17	0	0	17	0	0
3	133945718	.	A	G	4	2	6	0	0	6	0	0
3	135112631	.	T	C	58	14	72	0	0	72	0	0
4	21836550	.	A	G	56	8	64	0	1	65	0	0
4	32022582	.	A	G	56	8	64	0	2	66	0	0
4	33019420	.	A	G	90	39	129	0	5	134	0	0
4	33020417	.	A	G	80	78	158	0	1	159	0	0
4	41518514	.	T	C	294	41	335	0	7	342	0	0
4	43664414	.	A	C	7	3	10	1	0	11	0	0
4	43664415	.	A	T	7	3	10	1	0	11	0	0
4	86495344	.	G	T	72	17	89	0	1	91	1	0
4	103021909	.	A	G	18	8	26	0	3	29	0	0
4	108198313	.	A	G	10	12	22	0	0	22	0	0
4	116410052	.	T	C	14	3	17	0	1	18	0	0
4	118484005	.	A	G	14	29	43	0	0	43	0	0
4	118484020	.	A	G	32	4	36	0	4	40	0	0
4	118484072	.	A	G	12	6	18	0	1	19	0	0
4	119080668	.	T	C	19	3	22	0	0	22	0	0
4	119080724	.	T	C	19	4	23	0	1	24	0	0
4	119081410	.	T	C	10	6	16	0	2	18	0	0
4	124838094	.	A	G	11	13	24	0	0	24	0	0
4	125982944	.	A	G	9	13	22	0	0	22	0	0
4	125982950	.	A	G	23	3	26	0	0	26	0	0
4	125985458	.	A	G	16	3	19	0	0	19	0	0
4	126328822	.	C	T	3	2	5	0	0	6	1	0
4	129107038	.	A	G	5	3	8	0	0	8	0	0
4	134625164	.	A	G	11	2	13	0	0	13	0	0
4	137987341	.	A	G	114	21	135	0	2	137	0	0
4	137987354	.	A	G	95	27	122	0	4	126	0	0
4	140678893	.	A	G	13	6	19	0	0	19	0	0
4	140842602	.	G	A	6	2	8	0	0	8	0	0
4	148140817	.	A	G	19	2	21	0	0	21	0	0
4	149202654	.	A	G	39	4	43	0	2	45	0	0
4	149203211	.	A	G	23	9	32	0	0	32	0	0
4	149552635	.	T	C	2	6	8	0	1	9	0	0
4	150491027	.	G	A	31	0	31	0	8	39	0	0
4	155705982	.	A	G	13	2	15	0	2	17	0	0
4	155706828	.	A	G	22	5	27	2	3	32	0	0
4	155800341	.	A	G	13	4	17	0	0	17	0	0
4	155800978	.	A	G	10	4	14	0	0	14	0	0
4	156095123	.	A	G	81	66	147	0	3	150	0	0
4	156294088	.	A	G	1	3	4	0	1	5	0	0
5	5833142	.	A	G	1	5	6	2	1	9	0	0
5	24649635	.	T	C	34	3	37	1	1	39	0	0
5	29429060	.	G	T	3	1	4	0	0	4	0	0
5	29429063	.	T	C	3	1	4	0	0	4	0	0
5	30817017	.	G	A	2	2	4	0	1	5	0	0
5	31330824	.	T	C	2	3	5	0	0	5	0	0
5	33149755	.	A	G	20	4	24	0	1	25	0	0
5	65605388	.	T	C	69	18	87	0	3	90	0	0
5	65605389	.	T	C	46	40	86	0	3	89	0	0
5	65765485	.	A	G	6	2	8	2	1	11	0	0
5	77555578	.	T	C	3	27	30	0	1	31	0	0
5	81168532	.	G	A	9	2	11	0	1	12	0	0
5	110081429	.	C	T	5	4	9	0	0	9	0	0
5	110081431	.	C	T	6	3	9	0	0	9	0	0
5	115241332	.	T	C	1	3	4	10	0	14	0	0
5	115437319	.	T	C	10	4	14	0	0	14	0	0
5	115437904	.	T	C	11	2	13	0	0	13	0	0
5	121683511	.	T	C	20	3	23	0	0	23	0	0
5	122546590	.	A	G	17	4	21	0	2	23	0	0
5	122546790	.	A	G	16	2	18	0	0	18	0	0
5	122943915	.	C	T	2	2	4	0	0	4	0	0
5	123386729	.	A	G	19	9	28	0	0	28	0	0
5	123880070	.	T	C	11	2	13	0	0	13	0	0
5	125533830	.	A	G	15	3	18	0	0	18	0	0
5	125534541	.	A	G	66	41	107	1	2	111	1	0
5	129798517	.	A	G	18	5	23	0	1	24	0	0
5	130014307	.	A	G	76	11	87	0	2	89	0	0
5	130018011	.	A	G	10	2	12	0	2	14	0	0
5	132570854	.	T	A	3	3	6	0	2	8	0	0
5	135192126	.	A	G	9	2	11	0	0	11	0	0
5	135402657	.	A	G	1	3	4	0	0	4	0	0
5	135437709	.	T	C	13	5	18	0	0	18	0	0
5	135437715	.	T	C	15	4	19	0	0	19	0	0
5	136941953	.	A	G	124	32	156	0	2	158	0	0
5	142655047	.	A	G	93	35	128	0	0	128	0	0
5	142888875	.	G	T	28	11	39	0	1	40	0	0
5	144132139	.	C	T	5	2	7	0	0	7	0	0
6	29713997	.	A	G	2	1	3	0	1	4	0	0
6	31492600	.	A	G	12	4	16	0	0	16	0	0
6	31492602	.	A	G	10	5	15	0	0	15	0	0
6	34999041	.	A	G	7	2	9	0	0	9	0	0
6	37783098	.	C	T	5	2	7	25	2	34	0	0
6	37783131	.	C	T	0	2	2	16	3	21	0	0
6	37847782	.	A	G	13	4	17	0	0	17	0	0
6	38268267	.	T	C	8	2	10	0	0	10	0	0
6	47849226	.	A	G	9	2	11	0	0	11	0	0
6	49231812	.	T	C	5	2	7	0	2	9	0	0
6	49233394	.	T	C	12	3	15	0	0	15	0	0
6	66517065	.	A	G	2	2	4	0	0	4	0	0
6	66517625	.	A	G	9	8	17	0	0	17	0	0
6	66517635	.	A	G	15	2	17	0	1	18	0	0
6	67182761	.	T	C	1	2	3	0	0	3	0	0
6	86393034	.	A	G	1	3	4	0	1	5	0	0
6	87890574	.	G	A	4	2	6	0	0	6	0	0
6	96010042	.	T	C	1	4	5	6	0	11	0	0
6	96010183	.	T	C	5	3	8	2	0	10	0	0
6	113588107	.	A	G	3	2	5	0	0	5	0	0
6	113671744	.	G	T	2	1	3	0	2	5	0	0
6	115932045	.	T	A	28	0	28	0	9	37	0	0
6	122715481	.	T	C	1	2	3	0	0	3	0	0
6	126619121	.	T	C	67	28	95	0	3	98	0	0
6	133084860	.	A	G	7	2	9	0	0	9	0	0
6	134210508	.	C	G	5	2	7	0	0	7	0	0
6	134210513	.	C	G	5	2	7	0	0	7	0	0
6	142303840	.	G	A	1	2	3	0	0	3	0	0
7	3463600	.	A	G	138	18	156	0	2	158	0	0
7	6176879	.	A	G	2	2	4	0	0	4	0	0
7	12706157	.	A	G	9	2	11	0	0	11	0	0
7	12707543	.	A	G	4	3	7	0	1	8	0	0
7	12707548	.	A	G	5	3	8	0	0	8	0	0
7	16605458	.	T	C	9	4	13	0	0	13	0	0
7	16619272	.	A	G	8	88	96	0	0	96	0	0
7	16619450	.	A	G	14	5	19	0	0	19	0	0
7	16619714	.	A	G	78	19	97	0	0	97	0	0
7	18873733	.	T	C	11	6	17	0	0	17	0	0
7	18981774	.	C	G	1	8	9	0	0	9	0	0
7	19239403	.	T	C	2	2	4	0	0	4	0	0
7	19239404	.	T	C	1	2	3	0	1	4	0	0
7	23905313	.	G	A	1	3	4	0	0	4	0	0
7	23974184	.	G	A	1	9	10	2	1	13	0	0
7	23975294	.	A	G	3	4	7	6	0	13	0	0
7	26904341	.	A	G	3	2	5	0	2	7	0	0
7	26904993	.	A	G	1	8	9	0	0	9	0	0
7	26905060	.	A	G	5	4	9	0	0	9	0	0
7	27227593	.	T	C	88	22	110	1	3	114	0	0
7	42125604	.	A	G	11	3	14	0	0	14	0	0
7	43175439	.	T	C	9	2	11	0	0	11	0	0
7	45032973	.	T	C	5	7	12	0	0	12	0	0
7	49206073	.	A	G	1	2	3	0	0	3	0	0
7	58874873	.	T	C	6	2	8	0	0	8	0	0
7	61589804	.	T	C	1	2	3	0	1	4	0	0
7	79206023	.	A	G	31	4	35	0	2	37	0	0
7	81253540	.	T	C	25	6	31	0	0	31	0	0
7	81521958	.	A	G	10	3	13	0	0	13	0	0
7	83274886	.	T	C	7	3	10	0	1	11	0	0
7	83406162	.	T	C	1	4	5	9	0	14	0	0
7	97339361	.	C	A	11	1	12	0	5	17	0	0
7	97339366	.	C	A	9	4	13	0	1	14	0	0
7	103988513	.	T	C	1	2	3	0	0	3	0	0
7	110655309	.	T	C	24	21	45	0	3	48	0	0
7	121587468	.	T	C	2	4	6	0	0	6	0	0
7	123582103	.	A	G	34	5	39	0	0	39	0	0
7	123582585	.	A	G	17	5	22	0	0	22	0	0
7	126853494	.	A	G	38	12	50	0	0	50	0	0
7	126853784	.	A	G	58	8	66	0	2	68	0	0
7	127519013	.	A	G	1	2	3	0	0	3	0	0
7	130360893	.	A	T	3	4	7	0	0	7	0	0
7	139715640	.	A	G	1	8	9	0	0	9	0	0
7	139716717	.	A	G	6	2	8	0	0	8	0	0
7	140916604	.	A	G	30	7	37	0	5	42	0	0
7	141014406	.	T	G	6	3	9	0	9	18	0	0
7	142207010	.	T	C	49	14	63	0	1	64	0	0
8	12688987	.	C	T	2	3	5	0	1	6	0	0
8	14078025	.	T	C	12	3	15	0	0	15	0	0
8	14140659	.	G	A	30	3	33	0	0	33	0	0
8	14140661	.	A	C	29	3	32	0	0	32	0	0
8	19741629	.	C	T	2	3	5	2	0	7	0	0
8	19834807	.	A	T	14	2	16	51	1	68	0	0
8	19834818	.	G	A	14	2	16	46	0	62	0	0
8	20030843	.	C	T	26	5	31	11	0	42	0	0
8	20030855	.	G	A	21	5	26	13	0	39	0	0
8	20698008	.	A	T	20	6	26	10	0	36	0	0
8	20727130	.	G	A	25	14	39	9	0	48	0	0
8	27537841	.	A	G	4	2	6	0	0	6	0	0
8	42700052	.	A	G	2	2	4	6	0	10	0	0
8	42700280	.	T	C	1	2	3	2	0	5	0	0
8	48005015	.	G	T	20	4	24	0	2	26	0	0
8	69766592	.	A	G	12	4	16	0	1	17	0	0
8	69927015	.	A	T	1	2	3	1	0	4	0	0
8	69927022	.	C	A	2	1	3	1	0	4	0	0
8	70028598	.	G	A	3	2	5	1	0	6	0	0
8	71131397	.	G	A	2	1	3	0	1	4	0	0
8	71826392	.	A	G	13	5	18	0	0	18	0	0
8	72977426	.	A	G	26	45	71	0	1	73	1	0
8	84723069	.	T	A	5	2	7	0	1	8	0	0
8	84977744	.	T	C	2	2	4	0	0	4	0	0
8	91842902	.	T	C	3	2	5	0	0	5	0	0
8	94806362	.	T	C	6	2	8	0	0	8	0	0
8	94879775	.	A	C	2	1	3	0	3	6	0	0
8	94879781	.	A	C	4	1	5	0	3	8	0	0
8	104984451	.	A	G	1	2	3	0	0	3	0	0
8	104985791	.	A	G	1	2	3	0	0	3	0	0
8	104986580	.	A	G	2	3	5	0	0	5	0	0
8	104987504	.	A	G	1	3	4	0	0	4	0	0
8	110817217	.	A	G	30	11	41	0	3	44	0	0
8	111731758	.	T	C	27	9	36	0	1	37	0	0
8	121823764	.	T	C	3	3	6	0	0	6	0	0
8	125620546	.	T	C	19	3	22	0	0	22	0	0
8	125620861	.	T	C	28	10	38	0	0	38	0	0
8	125620868	.	T	C	35	5	40	0	0	40	0	0
8	130007592	.	T	A	4	2	6	0	0	6	0	0
9	3386017	.	A	G	21	3	24	0	0	24	0	0
9	3387701	.	A	G	15	4	19	0	0	19	0	0
9	3387771	.	A	G	22	8	30	0	2	32	0	0
9	3387790	.	A	G	17	4	21	0	1	22	0	0
9	4456006	.	T	C	7	23	30	0	2	32	0	0
9	8022080	.	T	C	16	3	19	0	0	19	0	0
9	20508055	.	A	G	9	2	11	0	1	12	0	0
9	20515757	.	A	G	4	4	8	0	0	8	0	0
9	20781697	.	A	G	30	6	36	0	0	36	0	0
9	44035400	.	T	C	2	2	4	0	0	4	0	0
9	44221129	.	T	C	2	5	7	0	0	7	0	0
9	45747294	.	C	T	2	2	4	1	0	5	0	0
9	50436200	.	T	G	8	1	9	0	0	9	0	0
9	50436201	.	G	T	8	1	9	0	0	9	0	0
9	55056705	.	A	G	13	2	15	0	0	15	0	0
9	57041680	.	A	G	11	2	13	0	0	13	0	0
9	57051592	.	T	C	13	3	16	0	0	16	0	0
9	57658827	.	C	T	9	2	11	0	0	11	0	0
9	65253476	.	A	G	5	2	7	0	0	7	0	0
9	95939293	.	A	G	28	6	34	0	0	34	0	0
9	103062470	.	C	A	15	3	18	0	0	18	0	0
9	103062472	.	C	A	4	3	7	0	1	8	0	0
9	107640487	.	T	C	4	3	7	0	0	7	0	0
9	118872058	.	A	T	10	1	11	0	2	13	0	0
9	123349983	.	A	G	13	2	15	0	0	15	0	0
9	124034058	.	T	G	27	6	33	3	1	37	0	0
X	7773342	.	A	G	7	2	9	0	0	9	0	0
X	7773818	.	A	G	4	2	6	0	0	6	0	0
X	40743129	.	A	G	21	106	127	0	1	128	0	0
X	40743165	.	A	G	4	2	6	0	0	6	0	0
X	55633003	.	T	C	35	10	45	0	0	45	0	0
X	60231705	.	A	G	7	6	13	0	0	13	0	0
X	69388256	.	T	C	50	11	61	0	2	63	0	0
X	73270255	.	T	C	11	7	18	0	0	18	0	0
X	73270256	.	T	C	6	13	19	0	0	19	0	0
X	73270468	.	T	C	9	20	29	0	0	29	0	0
X	82861767	.	A	G	10	2	12	0	0	12	0	0
X	97364566	.	G	C	17	2	19	0	0	19	0	0
X	100868318	.	T	C	0	2	2	1	1	4	0	0
X	102620158	.	T	C	3	6	9	0	0	9	0	0
X	102620159	.	T	C	2	7	9	0	0	9	0	0
X	102623385	.	T	C	11	2	13	0	3	16	0	0
X	102631489	.	T	C	5	2	7	0	0	7	0	0
X	106830700	.	T	C	61	7	68	0	0	68	0	0
X	145978689	.	A	G	57	13	70	0	0	70	0	0
X	149766871	.	T	C	37	20	57	1	8	66	0	0
X	149767614	.	T	C	112	72	184	0	4	189	1	0
X	159360986	.	A	G	29	4	33	0	1	34	0	0
X	164972992	.	A	G	9	5	14	8	0	22	0	0
Y	1016394	.	A	G	17	15	32	0	0	32	0	0
Y	1049036	.	A	G	3	2	5	0	0	5	0	0
