contig	position	variantID	refAllele	altAllele	refCount	altCount	totalCount	lowMAPQDepth	lowBaseQDepth	rawDepth	otherBases	improperPairs
1	9790061	.	T	C	8	5	13	0	0	13	0	0
1	9790109	.	T	C	7	2	9	0	0	9	0	0
1	13695965	.	T	C	7	6	13	7	0	20	0	0
1	22031785	.	T	C	4	10	14	0	0	14	0	0
1	37448671	.	G	T	7	3	10	0	1	11	0	0
1	39590794	.	A	T	9	4	13	0	2	15	0	0
1	39590795	.	G	T	10	4	14	0	2	16	0	0
1	51506146	.	T	C	1	2	3	0	0	3	0	0
1	51507738	.	T	C	2	1	3	0	1	4	0	0
1	51507771	.	T	C	1	2	3	0	0	3	0	0
1	58566410	.	C	T	20	5	25	1	4	30	0	0
1	58635113	.	G	A	1	2	3	0	0	3	0	0
1	59756998	.	A	G	4	2	6	0	0	6	0	0
1	59913367	.	A	G	43	19	62	0	1	63	0	0
1	60191150	.	A	G	5	2	7	0	3	10	0	0
1	60517747	.	A	G	42	22	64	1	8	73	0	0
1	63156443	.	A	G	1	6	7	0	0	7	0	0
1	66711873	.	A	G	67	39	106	1	5	112	0	0
1	74534986	.	C	A	2	1	3	0	2	5	0	0
1	74631584	.	A	G	5	2	7	0	0	7	0	0
1	75398649	.	A	G	22	5	27	0	1	28	0	0
1	75398702	.	A	G	18	3	21	0	0	21	0	0
1	75398708	.	A	G	3	17	20	0	2	22	0	0
1	86276528	.	T	C	11	5	16	0	1	17	0	0
1	88187311	.	C	T	2	2	4	0	0	4	0	0
1	88187834	.	G	A	1	2	3	0	1	4	0	0
1	88188121	.	A	C	2	4	6	0	1	7	0	0
1	88188150	.	C	A	1	5	6	0	0	6	0	0
1	88188255	.	C	T	4	2	6	0	0	6	0	0
1	88188277	.	C	G	3	2	5	0	0	5	0	0
1	88188444	.	G	C	1	2	3	0	0	3	0	0
1	88188461	.	C	G	1	2	3	0	0	3	0	0
1	88189404	.	C	T	2	3	5	0	0	5	0	0
1	88189563	.	C	T	3	4	7	0	0	7	0	0
1	88189611	.	A	G	2	3	5	0	0	5	0	0
1	88189641	.	G	C	2	3	5	0	0	5	0	0
1	88189668	.	A	G	2	4	6	0	0	6	0	0
1	88189685	.	C	A	3	2	5	0	0	5	0	0
1	88189707	.	C	T	6	2	8	0	1	9	0	0
1	88189784	.	A	G	2	2	4	0	0	4	0	0
1	88189938	.	C	A	3	2	5	0	0	5	0	0
1	88190661	.	G	C	5	2	7	0	0	7	0	0
1	88190717	.	G	C	6	5	11	0	0	11	0	0
1	88190781	.	C	T	3	2	5	0	1	6	0	0
1	88190921	.	C	T	1	8	9	0	1	10	0	0
1	88191018	.	A	T	2	9	11	0	0	11	0	0
1	88191035	.	T	A	3	7	10	0	0	10	0	0
1	88191237	.	A	C	12	34	46	0	2	48	0	0
1	88191320	.	C	T	12	23	35	0	0	35	0	0
1	88191468	.	C	G	5	58	63	0	2	65	0	0
1	88191706	.	G	A	26	7	33	0	0	33	0	0
1	88191710	.	T	C	11	20	31	0	0	31	0	0
1	88191864	.	G	T	56	8	64	0	1	65	0	0
1	88192008	.	C	T	49	11	60	0	6	66	0	0
1	88192048	.	G	C	14	39	53	0	0	53	0	0
1	88192098	.	G	A	44	15	59	0	0	59	0	0
1	88192243	.	A	G	8	45	53	0	1	54	0	0
1	88192700	.	G	A	13	35	48	0	0	48	0	0
1	88192756	.	G	A	13	44	57	0	1	58	0	0
1	88192980	.	A	G	4	43	47	2	3	52	0	0
1	88193031	.	C	G	14	18	32	1	1	34	0	0
1	88193194	.	C	T	3	7	10	4	2	16	0	0
1	88193292	.	T	A	1	3	4	7	0	11	0	0
1	88193568	.	A	C	1	4	5	42	0	47	0	0
1	88193917	.	G	A	10	20	30	22	2	54	0	0
1	88197053	.	T	C	13	19	32	0	0	32	0	0
1	88197991	.	A	G	13	33	46	0	0	46	0	0
1	88200605	.	C	A	1	8	9	0	0	9	0	0
1	88200653	.	A	C	1	11	12	0	0	12	0	0
1	88200771	.	G	A	11	2	13	0	0	13	0	0
1	88200832	.	C	T	6	10	16	0	1	17	0	0
1	88202664	.	A	G	2	3	5	1	0	6	0	0
1	88202772	.	A	T	28	5	33	2	0	35	0	0
1	88203670	.	C	T	1	2	3	0	1	4	0	0
1	88203782	.	G	A	1	4	5	0	0	5	0	0
1	88204960	.	T	C	3	24	27	1	0	28	0	0
1	89879528	.	A	C	3	1	4	0	0	4	0	0
1	93299307	.	A	G	14	3	17	0	0	17	0	0
1	118225383	.	C	T	7	2	9	0	0	9	0	0
1	118225697	.	T	C	6	2	8	0	0	8	0	0
1	131953439	.	T	C	13	13	26	0	0	26	0	0
1	143631121	.	T	C	22	8	30	0	0	30	0	0
1	155881055	.	A	G	1	2	3	0	2	5	0	0
1	156255182	.	T	C	3	11	14	0	0	14	0	0
1	156255601	.	T	C	6	4	10	0	0	10	0	0
1	160831257	.	G	A	8	2	10	0	1	11	0	0
1	160835342	.	T	C	8	2	10	0	0	10	0	0
1	160835343	.	T	C	6	3	9	0	1	10	0	0
1	160839934	.	T	C	4	2	6	0	0	6	0	0
1	162425767	.	A	G	45	10	55	0	5	60	0	0
1	171109565	.	A	G	9	2	11	0	1	12	0	0
1	178779812	.	T	C	8	3	11	0	1	12	0	0
1	180155087	.	T	C	3	2	5	3	1	9	0	0
1	180924020	.	T	C	20	6	26	0	1	27	0	0
1	181731983	.	A	G	23	12	35	1	1	37	0	0
1	183190594	.	A	G	10	7	17	0	0	17	0	0
1	183190682	.	A	G	15	4	19	0	0	19	0	0
10	5752116	.	A	G	4	24	28	2	0	30	0	0
10	5752204	.	A	G	6	4	10	2	0	12	0	0
10	5752387	.	A	C	2	6	8	5	0	13	0	0
10	5775697	.	A	G	1	3	4	0	0	4	0	0
10	11333810	.	C	T	24	8	32	0	5	37	0	0
10	11333814	.	C	T	26	6	32	0	5	37	0	0
10	14621525	.	C	T	4	3	7	164	0	171	0	0
10	14621526	.	C	T	5	2	7	117	0	124	0	0
10	18877832	.	A	G	5	2	7	0	0	7	0	0
10	33868452	.	T	C	6	5	11	0	0	11	0	0
10	38998051	.	A	C	5	2	7	0	0	7	0	0
10	49118584	.	T	C	5	4	9	0	0	9	0	0
10	49118640	.	T	C	12	5	17	0	0	17	0	0
10	49120426	.	T	C	8	33	41	1	0	42	0	0
10	49148872	.	T	C	5	33	38	0	0	38	0	0
10	49148885	.	T	C	3	28	31	0	0	31	0	0
10	57383221	.	A	G	2	3	5	0	0	5	0	0
10	57391874	.	C	T	7	4	11	0	0	11	0	0
10	62645542	.	T	C	2	2	4	0	0	4	0	0
10	62645914	.	T	C	7	2	9	0	1	10	0	0
10	69860458	.	G	A	13	21	34	0	5	39	0	0
10	73038538	.	A	G	1	5	6	0	0	6	0	0
10	76391416	.	A	G	10	4	14	0	1	15	0	0
10	76391424	.	A	G	9	5	14	0	1	15	0	0
10	80784471	.	A	G	7	2	9	0	1	10	0	0
10	81182083	.	T	C	26	5	31	0	0	31	0	0
10	81445420	.	G	A	1	2	3	0	0	3	0	0
10	82486613	.	T	C	17	8	25	0	0	25	0	0
10	93582974	.	C	A	1	2	3	0	0	3	0	0
10	93800484	.	T	C	13	3	16	0	0	16	0	0
10	93801937	.	T	C	6	3	9	0	0	9	0	0
10	94057224	.	A	G	9	7	16	0	0	16	0	0
10	94057234	.	A	G	11	5	16	0	0	16	0	0
10	119035181	.	A	G	8	2	10	0	0	10	0	0
11	3407590	.	A	G	9	2	11	0	0	11	0	0
11	4091399	.	T	C	13	3	16	0	0	16	0	0
11	4092085	.	T	C	15	12	27	0	0	27	0	0
11	4092790	.	T	C	14	13	27	0	0	27	0	0
11	24117920	.	G	A	8	3	11	0	0	11	0	0
11	35678738	.	A	G	43	7	50	0	2	52	0	0
11	43572939	.	A	G	3	4	7	0	0	7	0	0
11	43572970	.	A	G	5	2	7	0	0	7	0	0
11	43573028	.	A	G	4	3	7	0	0	7	0	0
11	45821425	.	T	C	11	4	15	0	0	15	0	0
11	46163470	.	T	C	103	404	507	0	3	510	0	0
11	48644072	.	A	T	0	2	2	22	1	25	0	0
11	48691187	.	C	T	30	15	45	0	1	46	0	0
11	52124644	.	A	G	3	3	6	0	0	6	0	0
11	53440228	.	A	G	135	120	255	0	12	267	0	0
11	54730814	.	T	C	14	4	18	0	0	18	0	0
11	59223663	.	T	G	3	1	4	0	4	8	0	0
11	59347027	.	A	G	15	12	27	0	0	27	0	0
11	59347029	.	A	G	14	11	25	0	1	26	0	0
11	59347072	.	A	G	19	5	24	0	0	24	0	0
11	59401881	.	A	G	7	4	11	0	0	11	0	0
11	67579383	.	C	G	15	4	19	1	22	42	0	0
11	69514179	.	A	G	7	2	9	0	0	9	0	0
11	69807381	.	G	A	10	3	13	0	0	13	0	0
11	69922950	.	A	G	7	3	10	0	0	10	0	0
11	69923921	.	A	G	4	2	6	0	1	7	0	0
11	69926813	.	A	G	2	4	6	0	0	6	0	0
11	69927946	.	A	G	7	6	13	0	0	13	0	0
11	74747553	.	T	C	1	2	3	0	0	3	0	0
11	75067170	.	T	C	31	18	49	0	1	50	0	0
11	75067258	.	T	C	21	12	33	0	0	33	0	0
11	75068285	.	T	C	21	7	28	0	0	28	0	0
11	77426880	.	T	C	42	13	55	0	0	55	0	0
11	78187480	.	A	G	2	2	4	0	0	4	0	0
11	78736472	.	A	G	1	8	9	0	0	9	0	0
11	82791835	.	C	G	2	0	2	0	6	8	0	0
11	86521333	.	T	C	1	3	4	3	1	8	0	0
11	86521517	.	A	G	1	1	2	2	2	6	0	0
11	87014114	.	A	G	12	2	14	0	0	14	0	0
11	88083921	.	T	C	8	2	10	0	0	10	0	0
11	88927134	.	T	C	10	2	12	0	1	13	0	0
11	88927208	.	T	C	5	12	17	0	0	17	0	0
11	95401202	.	A	G	13	6	19	0	3	22	0	0
11	97285031	.	A	C	6	4	10	0	1	11	0	0
11	97535690	.	T	C	17	5	22	0	0	22	0	0
11	97536428	.	T	C	17	4	21	0	0	21	0	0
11	97598552	.	A	G	3	2	5	0	0	5	0	0
11	97734000	.	A	G	52	10	62	0	3	65	0	0
11	98787088	.	T	C	8	1	9	0	1	10	0	0
11	99277008	.	A	G	6	2	8	0	0	8	0	0
11	100488792	.	T	C	10	5	15	0	0	15	0	0
11	101080710	.	A	C	17	5	22	0	4	26	0	0
11	101080714	.	G	C	23	5	28	0	9	37	0	0
11	101089557	.	T	C	11	4	15	0	0	15	0	0
11	101089729	.	T	C	11	2	13	0	2	15	0	0
11	101089802	.	T	C	5	5	10	0	1	11	0	0
11	102366881	.	A	T	5	1	6	0	3	9	0	0
11	102366884	.	G	T	4	0	4	0	6	10	0	0
11	102837091	.	T	C	8	4	12	0	0	12	0	0
11	105068803	.	T	C	2	2	4	0	0	4	0	0
11	105068804	.	T	C	2	2	4	0	0	4	0	0
11	109148234	.	T	C	3	2	5	0	0	5	0	0
11	109612977	.	G	A	4	1	5	0	0	5	0	0
11	116303813	.	T	C	4	3	7	0	0	7	0	0
11	116471963	.	T	C	10	43	53	0	3	56	0	0
11	120519173	.	C	T	13	7	20	0	0	20	0	0
11	120519181	.	A	T	13	1	14	0	7	21	0	0
12	3454168	.	A	G	45	9	54	7	1	62	0	0
12	3454248	.	A	G	18	22	40	5	6	51	0	0
12	3454647	.	A	G	47	48	95	7	5	107	0	0
12	3454648	.	A	G	79	20	99	7	2	108	0	0
12	3958221	.	C	T	10	4	14	0	5	19	0	0
12	3958222	.	C	T	10	1	11	0	8	19	0	0
12	8547666	.	A	T	2	2	4	0	0	4	0	0
12	15778865	.	A	T	3	3	6	0	1	7	0	0
12	17479602	.	A	G	14	4	18	1	1	20	0	0
12	17479613	.	A	G	13	4	17	0	0	17	0	0
12	17479809	.	A	G	17	12	29	0	1	30	0	0
12	17479860	.	A	G	23	5	28	0	0	28	0	0
12	27388168	.	G	T	7	1	8	0	1	9	0	0
12	46747117	.	T	C	45	12	57	0	1	58	0	0
12	51418190	.	A	G	1	2	3	0	0	3	0	0
12	54718540	.	T	C	30	15	45	0	0	45	0	0
12	54719142	.	T	C	25	6	31	0	0	31	0	0
12	69244102	.	A	G	16	6	22	0	0	22	0	0
12	69355129	.	C	T	1	1	2	0	1	3	0	0
12	71041403	.	A	G	6	33	39	0	0	39	0	0
12	71041903	.	A	G	6	13	19	0	1	20	0	0
12	71041909	.	A	G	12	4	16	0	0	16	0	0
12	71041945	.	A	G	19	7	26	0	2	28	0	0
12	71041954	.	A	G	16	12	28	0	2	30	0	0
12	71041984	.	A	G	22	10	32	0	1	33	0	0
12	72955836	.	T	C	7	2	9	0	0	9	0	0
12	72955837	.	T	C	4	4	8	0	0	8	0	0
12	72956113	.	T	C	16	6	22	0	0	22	0	0
12	72956114	.	T	C	18	3	21	0	0	21	0	0
12	72956148	.	T	C	1	11	12	0	0	12	0	0
12	72956155	.	T	C	7	4	11	0	0	11	0	0
12	73975614	.	A	G	4	4	8	0	0	8	0	0
12	75678010	.	C	T	4	3	7	5	0	12	0	0
12	78887986	.	T	C	5	3	8	0	1	9	0	0
12	80770510	.	A	G	5	2	7	0	0	7	0	0
12	80770523	.	A	G	1	6	7	0	0	7	0	0
12	81245339	.	G	A	15	16	31	0	1	32	0	0
12	81419057	.	T	C	2	2	4	0	0	4	0	0
12	81419225	.	C	T	3	1	4	0	1	5	0	0
12	81419593	.	T	C	2	2	4	0	1	5	0	0
12	83582758	.	G	A	1	2	3	0	0	3	0	0
12	100837974	.	A	G	6	4	10	0	0	10	0	0
12	101886131	.	T	C	17	7	24	0	1	25	0	0
12	101887890	.	T	C	14	6	20	0	0	20	0	0
12	104206650	.	C	G	1	3	4	42	0	46	0	0
12	104831249	.	G	A	2	3	5	0	0	5	0	0
12	109511197	.	C	A	10	4	14	0	14	28	0	0
12	109511202	.	C	A	5	19	24	0	4	28	0	0
12	109525448	.	A	G	626	98	724	0	11	736	1	0
12	116018543	.	A	G	1	5	6	0	1	7	0	0
12	116369364	.	G	C	1	5	6	0	0	6	0	0
13	3702324	.	A	G	10	2	12	0	2	14	0	0
13	3702325	.	A	G	11	2	13	0	1	14	0	0
13	3703271	.	T	A	3	6	9	0	0	10	1	0
13	5918220	.	T	C	15	4	19	0	14	33	0	0
13	8901801	.	T	C	13	3	16	0	0	16	0	0
13	14228102	.	T	C	25	6	31	0	2	33	0	0
13	17978887	.	T	C	7	3	10	0	0	10	0	0
13	17978950	.	T	C	2	4	6	0	0	6	0	0
13	17979133	.	T	C	5	3	8	0	0	8	0	0
13	21571267	.	G	T	2	2	4	0	0	4	0	0
13	21571270	.	C	T	4	1	5	0	1	6	0	0
13	21574169	.	T	C	6	5	11	0	0	11	0	0
13	21574225	.	T	C	12	5	17	0	0	17	0	0
13	21576493	.	T	C	2	2	4	0	0	4	0	0
13	24999535	.	A	G	1	4	5	0	0	5	0	0
13	29133075	.	G	T	4	3	7	0	0	8	1	0
13	29133076	.	C	T	5	4	9	0	0	9	0	0
13	38401726	.	T	C	3	2	5	0	0	5	0	0
13	47163686	.	T	C	2	2	4	2	0	6	0	0
13	51305477	.	A	T	8	2	10	24	31	65	0	0
13	59757017	.	A	G	3	2	5	0	0	5	0	0
13	64438124	.	T	C	12	3	15	0	0	15	0	0
13	67621265	.	T	C	4	5	9	0	0	9	0	0
13	67806944	.	T	C	3	3	6	0	1	7	0	0
13	67807003	.	T	C	3	5	8	0	0	8	0	0
13	67967482	.	T	C	2	2	4	0	0	4	0	0
13	67967727	.	T	C	2	3	5	0	0	5	0	0
13	75793018	.	G	A	12	3	15	50	1	66	0	0
13	75793212	.	C	T	2	8	10	10	1	21	0	0
13	76209513	.	A	G	5	2	7	0	0	7	0	0
13	83887294	.	C	T	29	3	32	0	5	37	0	0
13	92032478	.	A	C	7	2	9	0	5	14	0	0
13	92521565	.	C	G	5	2	7	0	0	7	0	0
13	100202931	.	A	G	1	2	3	0	0	3	0	0
13	100839304	.	T	C	18	5	23	0	0	23	0	0
13	100839326	.	T	C	18	12	30	0	1	31	0	0
13	100839340	.	T	C	10	14	24	0	0	24	0	0
13	119625401	.	G	T	12	4	16	0	0	16	0	0
13	120230616	.	T	C	1	2	3	0	0	3	0	0
14	10058181	.	A	G	121	47	168	0	5	174	1	0
14	14533725	.	T	C	4	17	21	0	1	22	0	0
14	21846832	.	A	G	17	40	57	0	4	61	0	0
14	21846833	.	A	G	48	13	61	0	0	61	0	0
14	21847779	.	A	G	75	24	99	0	0	99	0	0
14	21847872	.	A	G	60	9	69	0	1	70	0	0
14	26381874	.	T	C	5	2	7	0	0	7	0	0
14	26381875	.	T	C	5	2	7	0	0	7	0	0
14	26382360	.	T	C	5	5	10	0	0	10	0	0
14	29788078	.	T	C	14	7	21	0	0	21	0	0
14	31422583	.	T	C	39	17	56	0	1	57	0	0
14	31422619	.	T	C	32	13	45	0	0	45	0	0
14	31423408	.	T	C	34	5	39	0	0	39	0	0
14	32018582	.	A	G	26	9	35	0	0	35	0	0
14	32993827	.	G	A	5	2	7	0	0	7	0	0
14	45832276	.	C	A	6	2	8	0	0	8	0	0
14	47558234	.	A	G	5	5	10	8	0	18	0	0
14	47972374	.	G	C	4	1	5	0	0	5	0	0
14	51013458	.	T	C	8	4	12	0	0	12	0	0
14	51109987	.	A	G	6	4	10	0	0	10	0	0
14	52243661	.	A	C	4	2	6	0	5	11	0	0
14	52243667	.	A	C	3	5	8	0	1	9	0	0
14	52435637	.	A	G	5	2	7	0	1	8	0	0
14	52531686	.	A	G	22	58	80	0	1	81	0	0
14	55094670	.	A	G	9	2	11	0	0	11	0	0
14	55658193	.	A	G	2	1	3	0	2	5	0	0
14	55749057	.	A	G	8	4	12	0	0	12	0	0
14	55787563	.	A	G	2	3	5	0	0	5	0	0
14	59883055	.	A	G	7	2	9	0	2	11	0	0
14	60451313	.	T	C	3	5	8	0	0	8	0	0
14	65434640	.	T	C	29	12	41	0	0	42	1	0
14	75957159	.	T	C	23	8	31	0	1	32	0	0
14	99552141	.	C	T	3	2	5	0	0	5	0	0
14	103583875	.	T	C	9	2	11	0	0	11	0	0
14	103584115	.	T	C	21	8	29	0	0	29	0	0
14	109148057	.	C	G	10	7	17	0	4	21	0	0
14	121273016	.	A	G	4	3	7	0	0	7	0	0
15	3348888	.	C	A	4	1	5	0	1	6	0	0
15	8187674	.	A	G	13	9	22	0	0	22	0	0
15	8187696	.	A	G	13	3	16	0	1	17	0	0
15	8188973	.	A	G	6	4	10	0	2	12	0	0
15	9199559	.	A	G	34	16	50	0	4	54	0	0
15	11840860	.	A	G	5	2	7	0	0	7	0	0
15	12809789	.	T	C	38	7	45	0	2	47	0	0
15	55116094	.	A	G	9	2	11	0	0	11	0	0
15	75525421	.	T	C	2	3	5	0	1	6	0	0
15	79133222	.	G	A	17	16	33	0	1	34	0	0
15	79496070	.	T	C	6	3	9	0	0	9	0	0
15	80816550	.	A	G	4	5	9	0	0	9	0	0
15	81339166	.	A	G	10	6	16	0	0	16	0	0
15	81791419	.	A	G	4	2	6	0	0	6	0	0
15	82015818	.	A	G	2	3	5	0	0	5	0	0
15	84836683	.	T	C	7	3	10	0	0	10	0	0
15	98634993	.	T	C	18	33	51	0	1	52	0	0
15	98731431	.	T	C	22	6	28	0	0	28	0	0
15	98935173	.	C	T	4	4	8	453	0	461	0	0
15	99142536	.	T	C	68	19	87	10	3	100	0	0
15	99626051	.	A	G	9	4	13	0	0	13	0	0
15	99626091	.	A	G	7	2	9	0	0	9	0	0
15	99627261	.	A	G	1	3	4	0	0	4	0	0
15	99627262	.	A	G	2	2	4	0	0	4	0	0
16	4444275	.	T	C	2	2	4	0	0	4	0	0
16	4444284	.	T	C	3	2	5	0	0	5	0	0
16	8507493	.	C	T	17	4	21	0	0	21	0	0
16	8514085	.	A	G	4	2	6	0	0	6	0	0
16	13283445	.	A	G	1	2	3	0	0	3	0	0
16	13520445	.	A	G	19	5	24	0	0	24	0	0
16	13520501	.	A	G	10	2	12	0	0	12	0	0
16	13576064	.	A	G	1	2	3	0	0	3	0	0
16	13631815	.	C	T	31	4	35	0	1	36	0	0
16	13650452	.	A	G	8	3	11	0	0	11	0	0
16	13651947	.	T	C	24	5	29	0	2	31	0	0
16	13927109	.	T	C	5	7	12	0	10	22	0	0
16	13927112	.	A	C	7	2	9	0	15	24	0	0
16	16844849	.	A	G	4	4	8	0	0	8	0	0
16	16844860	.	A	G	5	3	8	0	0	8	0	0
16	17321752	.	A	G	14	5	19	0	0	19	0	0
16	18653678	.	A	G	57	20	77	0	2	79	0	0
16	19942498	.	A	G	39	27	66	0	1	67	0	0
16	20508413	.	A	G	7	2	9	0	0	9	0	0
16	30330773	.	T	C	10	3	13	0	0	13	0	0
16	32118665	.	A	G	20	7	27	0	1	28	0	0
16	32119106	.	A	G	24	12	36	0	2	38	0	0
16	32119150	.	A	G	26	12	38	0	0	38	0	0
16	32209076	.	C	T	8	3	11	0	2	13	0	0
16	57131671	.	A	G	17	4	21	0	2	23	0	0
16	72842228	.	G	T	18	3	21	0	3	24	0	0
16	78133495	.	A	G	3	2	5	0	0	5	0	0
16	87230813	.	T	C	12	2	14	0	0	14	0	0
16	87230814	.	T	C	11	3	14	0	0	14	0	0
16	87737431	.	T	C	4	8	12	0	1	13	0	0
16	91287590	.	A	G	2	2	4	0	0	4	0	0
16	91452503	.	A	G	94	15	109	0	4	113	0	0
16	91452977	.	A	G	61	34	95	0	0	95	0	0
16	91453021	.	A	G	75	16	91	0	1	92	0	0
16	92336842	.	C	T	9	2	11	0	1	12	0	0
16	97658408	.	T	C	3	3	6	0	0	6	0	0
17	6320824	.	C	G	17	3	20	0	0	20	0	0
17	6320836	.	G	A	18	3	21	1	0	22	0	0
17	10429111	.	C	T	2	2	4	0	0	4	0	0
17	15695793	.	T	C	4	2	6	0	0	6	0	0
17	15741073	.	A	G	5	4	9	0	0	9	0	0
17	15742534	.	A	G	2	2	4	0	0	4	0	0
17	18132829	.	C	T	2	2	4	1	0	5	0	0
17	24395416	.	T	C	61	12	73	0	0	73	0	0
17	24395428	.	T	C	64	25	89	0	1	90	0	0
17	24397285	.	T	C	25	21	46	0	0	46	0	0
17	24397327	.	T	C	10	14	24	0	1	25	0	0
17	24635698	.	A	G	6	4	10	0	0	10	0	0
17	24635786	.	A	G	9	2	11	0	1	12	0	0
17	27721769	.	T	C	9	3	12	0	0	12	0	0
17	28392510	.	C	T	1	2	3	0	0	3	0	0
17	29521001	.	A	G	6	4	10	0	1	11	0	0
17	29919711	.	G	T	2	4	6	0	0	6	0	0
17	32063514	.	C	A	1	3	4	0	3	7	0	0
17	32281461	.	G	A	7	2	9	0	0	9	0	0
17	32992239	.	G	T	5	4	9	0	1	10	0	0
17	33015107	.	T	C	4	2	6	0	0	6	0	0
17	33015482	.	T	C	15	3	18	0	0	18	0	0
17	33034548	.	T	C	13	2	15	0	0	15	0	0
17	33034549	.	T	C	10	5	15	0	0	15	0	0
17	33552004	.	T	C	10	4	14	0	0	14	0	0
17	33867517	.	T	C	4	2	6	0	0	6	0	0
17	34147531	.	A	G	21	11	32	0	2	34	0	0
17	36168626	.	A	G	5	5	10	0	0	10	0	0
17	36317333	.	T	C	13	2	15	0	0	15	0	0
17	40158498	.	T	C	3531	4706	8237	3	128	8792	424	0
17	45973875	.	T	C	42	78	120	0	9	129	0	0
17	46727251	.	A	G	5	5	10	0	0	10	0	0
17	46765496	.	G	A	5	5	10	0	2	12	0	0
17	46810304	.	A	G	4	4	8	0	0	8	0	0
17	47085856	.	T	C	26	9	35	0	0	35	0	0
17	47085857	.	T	C	21	12	33	0	0	33	0	0
17	50586902	.	G	A	3	3	6	0	0	6	0	0
17	62088129	.	T	C	1	3	4	1	0	5	0	0
17	63806215	.	T	C	15	4	19	0	0	19	0	0
17	72016580	.	C	T	6	2	8	0	0	8	0	0
17	78682975	.	G	T	8	2	10	0	0	10	0	0
17	87386211	.	G	A	1	1	2	2	2	6	0	0
17	88797008	.	G	T	6	3	9	0	0	9	0	0
17	88797009	.	C	T	6	3	9	0	0	9	0	0
17	95064364	.	T	C	6	4	10	0	0	10	0	0
17	95067396	.	T	C	9	10	19	0	0	19	0	0
17	95067479	.	T	C	11	10	21	0	1	22	0	0
17	95068514	.	T	C	25	4	29	0	0	29	0	0
17	95068552	.	T	C	36	7	43	0	0	43	0	0
17	95123375	.	T	C	3	2	5	0	0	5	0	0
18	4198525	.	T	C	5	2	7	36	0	43	0	0
18	6792757	.	A	G	16	6	22	0	2	24	0	0
18	6792802	.	A	G	15	5	20	0	0	20	0	0
18	6793749	.	A	G	15	4	19	0	0	19	0	0
18	6793776	.	A	G	14	4	18	0	0	18	0	0
18	10813843	.	A	G	85	14	99	0	2	101	0	0
18	24097917	.	A	G	7	5	12	0	0	12	0	0
18	24639050	.	T	C	9	2	11	0	0	11	0	0
18	32235557	.	A	G	7	7	14	0	0	14	0	0
18	32235595	.	A	G	3	15	18	0	0	18	0	0
18	32235652	.	A	G	3	10	13	0	0	13	0	0
18	32235930	.	A	G	3	5	8	0	0	8	0	0
18	32236019	.	A	G	6	4	10	0	0	10	0	0
18	32561134	.	A	G	29	16	45	0	0	45	0	0
18	35743341	.	A	G	11	2	13	0	0	13	0	0
18	35935410	.	A	G	5	3	8	0	0	8	0	0
18	38596909	.	A	G	3	2	5	0	0	5	0	0
18	46869696	.	T	C	8	2	10	0	0	10	0	0
18	55031875	.	T	C	10	2	12	0	0	12	0	0
18	57089576	.	T	C	2	7	9	0	1	10	0	0
18	57090006	.	T	C	11	4	15	0	0	15	0	0
18	59543586	.	A	T	5	2	7	0	0	7	0	0
18	65610148	.	A	G	4	2	6	0	0	6	0	0
18	69821991	.	A	C	27	8	35	0	4	39	0	0
18	77062550	.	A	G	13	17	30	0	0	30	0	0
18	80335838	.	T	A	3	1	4	0	5	9	0	0
19	4367848	.	C	T	19	4	23	0	6	29	0	0
19	4811133	.	T	C	7	3	10	0	1	11	0	0
19	4937709	.	T	C	27	4	31	0	1	32	0	0
19	4937728	.	T	C	28	5	33	0	0	33	0	0
19	4938525	.	A	T	4	4	8	0	0	8	0	0
19	5015429	.	A	G	3	2	5	0	0	5	0	0
19	7515480	.	A	G	18	5	23	0	0	23	0	0
19	8816897	.	A	C	12	7	19	0	2	21	0	0
19	8868253	.	A	G	13	2	15	0	0	15	0	0
19	8868268	.	A	G	9	4	13	0	0	13	0	0
19	8900145	.	A	G	2	6	8	0	0	8	0	0
19	10223060	.	T	C	31	56	87	0	2	89	0	0
19	10512634	.	A	C	19	6	25	0	3	28	0	0
19	10885930	.	A	G	2	3	5	0	1	6	0	0
19	10886122	.	A	G	4	2	6	0	0	6	0	0
19	10886159	.	A	G	3	2	5	0	0	5	0	0
19	12441626	.	A	G	29	5	34	0	0	34	0	0
19	40905972	.	G	T	5	1	6	0	1	7	0	0
19	42244238	.	G	C	15	4	19	0	9	28	0	0
19	42244242	.	G	C	20	3	23	0	6	29	0	0
19	43429601	.	A	G	15	15	30	0	0	31	1	0
19	43429753	.	A	G	32	8	40	0	0	40	0	0
19	44993669	.	T	C	29	8	37	0	1	38	0	0
19	46269407	.	A	G	1	2	3	0	0	3	0	0
19	46584105	.	A	G	1	3	4	0	0	4	0	0
19	46584110	.	A	G	2	2	4	0	0	4	0	0
19	46584812	.	A	G	2	3	5	0	0	5	0	0
19	46584822	.	A	G	4	2	6	0	0	6	0	0
2	3508326	.	A	C	4	2	6	2	0	8	0	0
2	5902865	.	T	C	2	2	4	0	0	4	0	0
2	10261256	.	C	T	6	2	8	0	0	8	0	0
2	14153492	.	A	G	1	10	11	0	0	11	0	0
2	14153493	.	A	G	1	10	11	0	0	11	0	0
2	14153560	.	A	G	6	10	16	0	0	16	0	0
2	14153568	.	A	G	11	8	19	0	0	19	0	0
2	18219539	.	T	C	5	5	10	0	0	10	0	0
2	18219544	.	T	C	7	3	10	0	0	10	0	0
2	22479057	.	T	C	1	3	4	3	4	11	0	0
2	22479348	.	G	A	10	9	19	48	40	107	0	0
2	25597684	.	T	A	7	2	9	0	0	9	0	0
2	25597686	.	C	A	7	2	9	0	0	9	0	0
2	26271752	.	A	G	3	4	7	0	0	7	0	0
2	26271758	.	A	G	5	4	9	0	0	9	0	0
2	26846568	.	T	C	5	2	7	0	0	7	0	0
2	26848217	.	T	C	6	3	9	0	0	9	0	0
2	29142459	.	G	T	1	1	2	0	0	2	0	0
2	29961700	.	C	T	12	17	29	8	5	42	0	0
2	30174243	.	A	T	5	4	9	0	0	9	0	0
2	30920955	.	T	C	28	5	33	0	1	34	0	0
2	31040896	.	T	C	1	2	3	0	0	3	0	0
2	31505906	.	A	G	13	2	15	0	0	15	0	0
2	31506608	.	C	T	6	2	8	0	3	11	0	0
2	31506610	.	G	T	8	2	10	0	1	11	0	0
2	32174582	.	T	C	5	2	7	0	0	7	0	0
2	32911428	.	T	C	1	4	5	0	0	5	0	0
2	32911454	.	T	C	2	2	4	0	0	4	0	0
2	38902454	.	A	G	3	2	5	0	0	5	0	0
2	40445910	.	G	T	0	3	3	4	3	10	0	0
2	52318355	.	C	T	5	2	7	0	1	8	0	0
2	52318356	.	A	T	6	0	6	0	3	9	0	0
2	52321031	.	A	T	21	3	24	0	7	31	0	0
2	52321032	.	G	T	23	3	26	0	3	29	0	0
2	55005781	.	C	T	14	2	16	0	0	16	0	0
2	55005783	.	G	T	14	2	16	0	0	16	0	0
2	59185548	.	G	A	6	2	8	0	0	8	0	0
2	59185550	.	G	A	1	2	3	0	0	3	0	0
2	66314260	.	G	C	1	4	5	3	0	8	0	0
2	66314290	.	A	C	2	3	5	0	1	6	0	0
2	76427859	.	G	C	10	2	12	0	10	22	0	0
2	76427865	.	G	C	15	3	18	0	8	26	0	0
2	76428783	.	A	C	10	3	13	0	8	21	0	0
2	76428789	.	A	C	12	4	16	0	4	20	0	0
2	80668540	.	G	A	0	3	3	6	2	11	0	0
2	83636894	.	G	T	7	2	9	0	0	9	0	0
2	83711742	.	C	A	83	47	130	0	4	134	0	0
2	90263321	.	G	A	2	5	7	1	2	10	0	0
2	90263322	.	C	A	0	1	1	2	8	11	0	0
2	90728419	.	T	C	9	2	11	0	0	11	0	0
2	91043632	.	A	G	45	11	56	0	0	56	0	0
2	91064743	.	T	C	9	3	12	0	0	12	0	0
2	91551466	.	A	G	9	2	11	0	1	12	0	0
2	102612558	.	T	A	206	57	263	1	21	285	0	0
2	104511430	.	T	C	13	4	17	0	0	17	0	0
2	112185846	.	A	G	2	4	6	0	0	6	0	0
2	112185852	.	A	G	4	2	6	0	0	6	0	0
2	114347125	.	G	T	5	2	7	0	0	7	0	0
2	114347126	.	G	T	5	0	5	0	2	7	0	0
2	117173318	.	C	A	123	82	205	0	2	207	0	0
2	118700801	.	A	G	11	3	14	0	0	14	0	0
2	119128835	.	T	C	2	2	4	0	1	5	0	0
2	120564258	.	T	C	27	28	55	0	0	55	0	0
2	120564286	.	T	C	43	11	54	0	0	54	0	0
2	120564302	.	T	C	32	21	53	0	3	56	0	0
2	120988975	.	A	G	4	2	6	0	0	6	0	0
2	121015462	.	A	G	1	3	4	0	0	4	0	0
2	121374228	.	A	G	3	4	7	0	0	7	0	0
2	122199390	.	T	C	11	2	13	0	4	17	0	0
2	122199409	.	C	G	8	2	10	0	6	16	0	0
2	126733408	.	T	C	12	5	17	0	0	17	0	0
2	126733420	.	T	C	16	3	19	0	0	19	0	0
2	126734766	.	T	C	6	5	11	0	3	14	0	0
2	126734771	.	T	C	7	4	11	0	0	11	0	0
2	126734836	.	T	C	17	5	22	0	2	24	0	0
2	130396876	.	A	G	6	5	11	0	0	11	0	0
2	130397819	.	A	G	11	2	13	0	0	13	0	0
2	130397909	.	A	G	5	4	9	0	0	9	0	0
2	130397973	.	A	G	1	6	7	0	0	7	0	0
2	130397974	.	A	G	2	5	7	0	0	7	0	0
2	132151800	.	A	G	35	298	333	0	7	340	0	0
2	132636996	.	C	A	4	3	7	0	0	7	0	0
2	132708131	.	G	T	25	3	28	0	5	33	0	0
2	136913796	.	T	C	2	2	4	0	0	4	0	0
2	140501239	.	C	T	11	7	18	0	2	20	0	0
2	144381830	.	A	G	13	4	17	0	0	17	0	0
2	149585919	.	C	T	0	3	3	0	3	6	0	0
2	152114942	.	A	G	3	8	11	0	0	11	0	0
2	153108492	.	A	G	16	3	19	0	0	19	0	0
2	153460309	.	T	C	2	7	9	0	0	9	0	0
2	153460310	.	T	C	5	4	9	0	0	9	0	0
2	154379850	.	A	G	34	9	43	0	0	43	0	0
2	155980520	.	T	C	3	3	6	0	0	6	0	0
2	157313041	.	A	C	13	10	23	0	7	30	0	0
2	157400060	.	T	C	102	25	127	1	6	134	0	0
2	157400069	.	T	C	96	35	131	1	1	133	0	0
2	158220838	.	A	G	11	8	19	0	1	20	0	0
2	158226873	.	A	G	114	327	441	0	21	462	0	0
2	163309459	.	T	C	9	15	24	0	0	24	0	0
2	163310345	.	T	C	33	7	40	0	0	40	0	0
2	164266227	.	T	A	2	0	2	0	3	5	0	0
2	164306821	.	G	A	14	9	23	0	5	28	0	0
2	164953773	.	T	C	35	11	46	0	0	46	0	0
2	168055230	.	T	C	4	2	6	0	1	7	0	0
2	169913325	.	A	G	3	5	8	0	0	8	0	0
2	169913421	.	A	G	7	6	13	0	1	14	0	0
2	174169694	.	A	G	134	39	173	1	2	176	0	0
2	174548497	.	C	T	7	3	10	0	3	13	0	0
2	176411921	.	A	T	9	3	12	4	0	16	0	0
2	177673966	.	T	C	14	2	16	2	0	18	0	0
3	9494242	.	T	C	7	2	9	0	6	15	0	0
3	9494248	.	G	C	8	3	11	0	5	16	0	0
3	10406523	.	T	C	2	2	4	0	0	4	0	0
3	18111642	.	T	A	7	2	9	0	0	10	1	0
3	19278361	.	T	C	2	2	4	0	0	4	0	0
3	26385911	.	T	C	17	3	20	0	0	20	0	0
3	32393742	.	T	G	12	5	17	5	3	25	0	0
3	32615620	.	A	G	65	13	78	0	0	78	0	0
3	32615624	.	C	T	69	21	90	0	3	93	0	0
3	32636549	.	T	C	12	9	21	0	0	21	0	0
3	36146600	.	A	G	2	2	4	0	0	4	0	0
3	40747624	.	A	G	36	10	46	0	0	46	0	0
3	40747629	.	A	G	29	14	43	0	1	44	0	0
3	40748697	.	A	G	45	8	53	10	0	63	0	0
3	45389662	.	C	T	6	1	7	0	2	9	0	0
3	45389665	.	C	T	8	1	9	0	1	10	0	0
3	57551841	.	T	C	1	2	3	0	0	3	0	0
3	57553351	.	T	C	2	3	5	0	0	5	0	0
3	63929640	.	T	A	3	2	5	0	0	5	0	0
3	65866372	.	A	G	4	2	6	0	0	6	0	0
3	65868019	.	A	G	7	2	9	0	0	9	0	0
3	68533367	.	C	T	48	14	62	0	42	104	0	0
3	68901450	.	T	C	3	2	5	0	0	5	0	0
3	68901456	.	T	C	0	2	2	0	0	2	0	0
3	80599593	.	T	C	125	198	323	3	5	331	0	0
3	80614159	.	T	C	10	9	19	0	0	19	0	0
3	80614215	.	T	C	266	105	371	1	6	378	0	0
3	88238210	.	A	G	1	2	3	0	0	3	0	0
3	88259488	.	A	G	4	5	9	0	0	10	1	0
3	88259498	.	A	G	2	8	10	0	0	10	0	0
3	88259542	.	A	G	12	3	15	0	0	15	0	0
3	88259584	.	A	G	4	4	8	0	0	8	0	0
3	88259907	.	A	G	2	3	5	0	0	5	0	0
3	89675221	.	T	C	10	2	12	0	0	12	0	0
3	89675614	.	T	C	6	5	11	0	0	11	0	0
3	89967705	.	A	G	5	3	8	0	0	8	0	0
3	89967924	.	A	G	3	6	9	0	1	10	0	0
3	89967938	.	A	G	6	3	9	0	0	9	0	0
3	93353627	.	A	T	8	1	9	0	0	9	0	0
3	93353631	.	C	A	8	1	9	0	0	9	0	0
3	94311127	.	G	A	3	2	5	0	0	5	0	0
3	94794244	.	T	A	13	3	16	0	0	16	0	0
3	94794245	.	G	A	13	3	16	0	0	16	0	0
3	96127814	.	A	G	1	3	4	0	0	4	0	0
3	96539776	.	A	G	2	21	23	0	1	24	0	0
3	96540029	.	A	G	18	5	23	0	1	24	0	0
3	101346949	.	T	C	3	1	4	0	0	4	0	0
3	101483703	.	G	C	41	13	54	0	31	85	0	0
3	102973406	.	A	G	32	12	44	0	2	46	0	0
3	104835352	.	A	G	5	4	9	0	0	9	0	0
3	105634359	.	A	G	2	2	4	0	1	5	0	0
3	116537746	.	T	C	20	5	25	0	1	26	0	0
3	116537808	.	T	C	15	5	20	0	0	20	0	0
3	135112631	.	T	C	53	9	62	0	0	62	0	0
3	146435333	.	A	T	2	5	7	0	0	7	0	0
4	10989135	.	C	A	3	2	5	0	1	6	0	0
4	21869677	.	A	T	15	3	18	0	6	24	0	0
4	21911667	.	A	G	11	5	16	0	0	16	0	0
4	21911675	.	A	G	13	6	19	0	0	19	0	0
4	21911872	.	A	G	11	2	13	0	0	13	0	0
4	21911886	.	A	G	14	3	17	0	0	17	0	0
4	21996098	.	A	C	20	6	26	0	2	28	0	0
4	33019420	.	A	G	79	19	98	0	1	99	0	0
4	33020417	.	A	G	68	60	128	0	1	129	0	0
4	33945697	.	T	C	39	36	75	0	1	76	0	0
4	41169271	.	T	C	1	2	3	0	0	3	0	0
4	41169272	.	A	G	1	2	3	0	0	3	0	0
4	41518514	.	T	C	187	32	219	0	4	223	0	0
4	43664077	.	G	C	5	2	7	24	0	31	0	0
4	55081616	.	C	A	7	5	12	0	1	13	0	0
4	55385495	.	G	A	7	2	9	0	0	9	0	0
4	56870216	.	T	C	9	2	11	0	0	11	0	0
4	56870260	.	T	C	7	5	12	0	1	13	0	0
4	56875812	.	T	C	4	2	6	0	0	6	0	0
4	57143018	.	T	C	8	2	10	0	0	10	0	0
4	86495344	.	G	T	52	15	67	1	4	73	1	0
4	103021909	.	A	G	18	5	23	0	1	24	0	0
4	106298400	.	A	C	18	5	23	0	0	23	0	0
4	108198313	.	A	G	3	3	6	0	1	7	0	0
4	108690513	.	T	C	9	2	11	0	0	11	0	0
4	116409401	.	T	C	11	2	13	0	0	13	0	0
4	118484005	.	A	G	10	18	28	0	0	28	0	0
4	119080668	.	T	C	7	5	12	0	0	12	0	0
4	119135361	.	C	T	30	38	68	1	21	90	0	0
4	121003224	.	A	G	5	2	7	0	0	7	0	0
4	124832762	.	A	G	3	2	5	0	0	5	0	0
4	124832765	.	A	G	1	3	4	0	0	4	0	0
4	124838094	.	A	G	15	9	24	0	1	25	0	0
4	124838166	.	A	G	17	4	21	0	0	21	0	0
4	124838169	.	A	G	14	6	20	0	0	20	0	0
4	125982944	.	A	G	9	8	17	0	1	18	0	0
4	125982950	.	A	G	11	4	15	0	1	16	0	0
4	125982989	.	A	G	10	2	12	0	0	12	0	0
4	125984993	.	A	G	7	2	9	0	3	12	0	0
4	125985065	.	A	G	8	5	13	0	1	14	0	0
4	125985112	.	A	G	12	4	16	0	1	17	0	0
4	129586229	.	C	T	8	2	10	0	0	10	0	0
4	131679966	.	T	C	18	4	22	0	1	23	0	0
4	135483725	.	A	G	1	3	4	0	0	4	0	0
4	137987341	.	A	G	75	19	94	0	0	94	0	0
4	137987354	.	A	G	65	28	93	0	1	94	0	0
4	138184300	.	A	G	1	3	4	0	0	4	0	0
4	139376720	.	A	C	10	1	11	0	6	17	0	0
4	139376726	.	A	C	10	2	12	0	6	18	0	0
4	144314687	.	A	G	4	3	7	24	0	31	0	0
4	147907770	.	T	C	4	3	7	0	0	7	0	0
4	147909430	.	T	C	8	4	12	0	0	12	0	0
4	148140817	.	A	G	13	3	16	0	0	16	0	0
4	149202586	.	A	G	31	9	40	0	2	42	0	0
4	149203211	.	A	G	17	5	22	0	1	23	0	0
4	149552635	.	T	C	3	5	8	0	2	10	0	0
4	154049751	.	G	A	8	2	10	0	1	11	0	0
4	155800938	.	A	G	6	4	10	0	0	10	0	0
4	155800977	.	A	G	8	2	10	0	0	10	0	0
4	156095123	.	A	G	76	42	118	0	1	119	0	0
4	156105048	.	T	C	9	3	12	0	0	12	0	0
4	156105693	.	T	C	10	7	17	0	0	17	0	0
5	23945753	.	A	G	7	2	9	0	0	9	0	0
5	24649635	.	T	C	22	4	26	0	2	28	0	0
5	24649804	.	T	C	12	17	29	0	0	29	0	0
5	25894974	.	G	A	5	1	6	0	0	6	0	0
5	25897453	.	A	T	7	1	8	0	2	10	0	0
5	29658129	.	A	G	1	2	3	0	0	3	0	0
5	30780828	.	G	A	4	1	5	0	6	11	0	0
5	31330824	.	T	C	7	5	12	0	0	12	0	0
5	33149571	.	A	G	6	3	9	0	1	10	0	0
5	33573262	.	A	G	7	5	12	0	0	12	0	0
5	33573281	.	A	G	6	5	11	0	0	11	0	0
5	33573900	.	A	G	6	3	9	0	0	9	0	0
5	36157689	.	C	T	10	2	12	0	1	13	0	0
5	36157699	.	C	T	9	1	10	0	1	11	0	0
5	54155989	.	A	C	2	4	6	0	1	8	1	0
5	65605388	.	T	C	60	16	76	0	2	78	0	0
5	65605389	.	T	C	41	33	74	0	4	78	0	0
5	73469787	.	A	G	73	13	86	0	0	86	0	0
5	77555578	.	T	C	3	13	16	0	0	17	1	0
5	88904267	.	C	T	9	4	13	0	4	17	0	0
5	88906486	.	C	T	8	3	11	0	0	11	0	0
5	96413280	.	G	T	4	1	5	0	3	8	0	0
5	96413281	.	A	T	5	1	6	0	2	8	0	0
5	104652843	.	A	G	21	7	28	0	0	28	0	0
5	104652845	.	A	G	22	7	29	0	1	30	0	0
5	113235693	.	T	C	10	18	28	1	0	29	0	0
5	113235700	.	T	C	18	19	37	1	0	38	0	0
5	113873957	.	A	C	3	1	4	0	3	7	0	0
5	114894305	.	T	C	1	1	2	0	0	2	0	0
5	115434850	.	G	A	12	2	14	0	1	15	0	0
5	115483707	.	A	G	4	2	6	0	0	6	0	0
5	117343472	.	A	G	1	2	3	0	0	3	0	0
5	117343491	.	A	G	1	2	3	0	0	3	0	0
5	121581241	.	T	C	2	2	4	0	0	4	0	0
5	121941595	.	A	G	2	3	5	0	0	5	0	0
5	121943596	.	A	G	3	3	6	0	0	6	0	0
5	122546790	.	A	G	12	2	14	0	0	14	0	0
5	123386729	.	A	G	20	11	31	0	0	31	0	0
5	123879315	.	T	C	5	8	13	0	0	13	0	0
5	123879325	.	T	C	6	3	9	0	0	9	0	0
5	123879350	.	T	C	7	3	10	0	1	11	0	0
5	123880062	.	T	C	8	2	10	0	0	10	0	0
5	125533669	.	A	G	22	71	93	0	4	97	0	0
5	125533687	.	A	G	75	21	96	0	3	99	0	0
5	125534541	.	A	G	53	22	75	1	0	76	0	0
5	129797823	.	A	G	5	17	22	0	0	22	0	0
5	129892662	.	A	G	17	3	20	0	0	20	0	0
5	130019253	.	A	G	3	2	5	0	0	5	0	0
5	130019272	.	A	G	4	1	5	0	1	6	0	0
5	131466449	.	C	T	5	3	8	0	8	16	0	0
5	134192591	.	C	T	12	3	15	0	0	15	0	0
5	135192126	.	A	G	8	2	10	0	0	10	0	0
5	135402657	.	A	G	1	2	3	0	0	3	0	0
5	136941953	.	A	G	79	20	99	0	0	99	0	0
5	137525546	.	G	T	7	3	10	0	2	12	0	0
5	140510846	.	A	C	8	4	12	0	2	14	0	0
5	140510852	.	G	C	14	4	18	0	0	18	0	0
5	140606802	.	T	G	18	4	22	0	13	35	0	0
5	142655047	.	A	G	82	24	106	0	1	107	0	0
5	142855980	.	T	C	2	4	6	0	1	7	0	0
5	142855997	.	T	C	6	1	7	0	1	8	0	0
5	143381709	.	A	G	7	2	9	0	0	9	0	0
5	143382034	.	A	G	8	2	10	0	0	10	0	0
5	143382050	.	A	G	3	7	10	0	0	10	0	0
5	143382388	.	A	G	3	4	7	0	0	7	0	0
5	143382882	.	A	G	6	2	8	0	0	8	0	0
5	143751066	.	A	G	11	3	14	1	0	15	0	0
5	143883169	.	A	G	1	2	3	0	0	3	0	0
5	148985213	.	G	A	6	7	13	79	8	100	0	0
5	150561734	.	T	C	13	2	15	0	0	15	0	0
6	17990026	.	C	T	1	8	9	0	0	9	0	0
6	18145017	.	T	C	1	2	3	0	0	3	0	0
6	18429956	.	G	A	1	8	9	0	1	10	0	0
6	18430049	.	T	C	1	12	13	0	0	13	0	0
6	31486635	.	A	C	11	3	14	0	2	16	0	0
6	31486641	.	G	C	16	2	18	0	2	20	0	0
6	31492600	.	A	G	18	3	21	0	3	24	0	0
6	31492602	.	A	G	11	9	20	0	2	22	0	0
6	34751192	.	A	C	14	3	17	0	1	18	0	0
6	34751198	.	A	C	11	4	15	0	1	16	0	0
6	34854609	.	A	G	11	2	13	0	1	14	0	0
6	37847782	.	A	G	6	6	12	0	1	13	0	0
6	38265837	.	T	C	7	2	9	0	0	9	0	0
6	39312088	.	T	C	17	7	24	0	1	25	0	0
6	47844733	.	C	T	5	2	7	0	0	7	0	0
6	47848259	.	A	G	12	3	15	0	0	15	0	0
6	47848294	.	A	G	11	2	13	0	0	13	0	0
6	47848366	.	A	G	11	2	13	0	0	13	0	0
6	47848373	.	A	G	7	3	10	0	0	10	0	0
6	47849226	.	A	G	6	3	9	0	0	9	0	0
6	48375235	.	A	G	2	4	6	0	0	6	0	0
6	49233358	.	T	C	6	3	9	0	1	10	0	0
6	49233394	.	T	C	12	3	15	0	0	15	0	0
6	49237899	.	T	C	13	5	18	0	0	18	0	0
6	49237955	.	T	C	14	3	17	0	1	18	0	0
6	49237956	.	T	C	14	3	17	0	0	17	0	0
6	61288779	.	C	T	1	10	11	0	0	11	0	0
6	61288787	.	G	A	1	12	13	0	0	13	0	0
6	65684442	.	A	G	2	5	7	0	0	7	0	0
6	65687724	.	A	G	2	3	5	0	0	5	0	0
6	66517065	.	A	G	5	5	10	0	0	10	0	0
6	66517110	.	A	G	5	4	9	0	0	9	0	0
6	66517196	.	A	G	2	4	6	0	0	6	0	0
6	66517254	.	A	G	5	2	7	0	0	7	0	0
6	66517625	.	A	G	8	6	14	0	0	14	0	0
6	66517775	.	A	G	14	3	17	0	0	17	0	0
6	67273501	.	A	G	8	4	12	0	0	12	0	0
6	70743250	.	G	T	8	2	10	0	1	11	0	0
6	71791046	.	T	C	13	2	15	0	0	15	0	0
6	86391922	.	A	G	2	2	4	1	0	5	0	0
6	87067469	.	A	T	1	7	8	0	0	8	0	0
6	87113982	.	G	C	0	7	7	0	0	7	0	0
6	87113983	.	T	C	1	7	8	0	0	8	0	0
6	87791772	.	T	C	7	3	10	0	0	10	0	0
6	87791783	.	T	C	7	2	9	0	0	9	0	0
6	87795142	.	T	C	9	3	12	0	0	12	0	0
6	89293495	.	T	G	13	8	21	0	8	29	0	0
6	91880140	.	A	G	1	2	3	0	0	3	0	0
6	96010042	.	T	C	2	3	5	3	1	9	0	0
6	99497627	.	C	T	8	3	11	1	0	12	0	0
6	115229054	.	G	A	1	2	3	0	0	3	0	0
6	115229055	.	C	A	1	0	1	0	2	3	0	0
6	118454383	.	C	G	1	9	10	0	0	10	0	0
6	118478591	.	C	T	2	13	15	0	0	15	0	0
6	118483481	.	T	A	7	2	9	0	0	9	0	0
6	118500305	.	C	T	1	7	8	0	0	8	0	0
6	118500320	.	A	G	1	5	6	0	2	8	0	0
6	118566170	.	T	C	8	6	14	2	1	17	0	0
6	118566174	.	C	T	14	4	18	2	0	21	1	0
6	118566344	.	A	G	1	5	6	0	0	6	0	0
6	119194385	.	A	G	1	5	6	0	0	6	0	0
6	120743411	.	C	T	1	6	7	0	0	7	0	0
6	120746026	.	A	G	1	2	3	0	0	3	0	0
6	122715481	.	T	C	3	2	5	0	0	5	0	0
6	124787015	.	A	G	5	5	10	0	0	10	0	0
6	124787022	.	T	G	4	5	9	0	0	9	0	0
6	124787056	.	A	C	3	2	5	0	0	5	0	0
6	125171627	.	A	G	4	2	6	0	0	6	0	0
6	125217465	.	A	G	4	2	6	0	0	6	0	0
6	126619121	.	T	C	67	33	100	0	2	102	0	0
6	134517979	.	G	T	5	1	6	0	3	9	0	0
6	134518327	.	C	G	9	2	11	0	0	11	0	0
6	142534776	.	T	C	5	2	7	0	0	7	0	0
6	146733792	.	A	G	2	2	4	0	0	4	0	0
7	3386270	.	A	G	4	3	7	0	0	7	0	0
7	3463600	.	A	G	105	18	123	0	5	128	0	0
7	4899732	.	A	G	5	2	7	0	0	7	0	0
7	6357880	.	A	G	2	3	5	0	0	5	0	0
7	6357928	.	A	G	5	2	7	0	0	7	0	0
7	6358535	.	A	G	7	2	9	0	0	9	0	0
7	6433526	.	A	G	17	5	22	0	0	22	0	0
7	6678646	.	T	C	1	5	6	0	0	6	0	0
7	6967909	.	A	G	12	11	23	0	0	23	0	0
7	6967915	.	A	G	18	5	23	0	0	23	0	0
7	6968013	.	A	G	8	5	13	1	0	14	0	0
7	6968063	.	T	G	6	8	14	2	1	17	0	0
7	6969513	.	A	G	10	21	31	0	0	31	0	0
7	6969571	.	C	T	1	11	12	0	1	13	0	0
7	7272299	.	C	T	1	3	4	0	0	4	0	0
7	12212392	.	A	G	9	3	12	0	0	12	0	0
7	12706135	.	A	G	5	3	8	0	0	8	0	0
7	12706157	.	A	G	7	5	12	0	0	12	0	0
7	12707543	.	A	G	4	2	6	0	0	6	0	0
7	12707548	.	A	G	2	3	5	0	0	5	0	0
7	15864164	.	G	C	2	2	4	0	5	9	0	0
7	15864170	.	T	C	4	2	6	0	3	9	0	0
7	15887215	.	C	T	1	268	269	0	6	275	0	0
7	16348719	.	C	G	1	6	7	0	0	7	0	0
7	16348726	.	G	A	1	2	3	0	0	3	0	0
7	16515475	.	T	A	2	4	6	0	0	6	0	0
7	16589769	.	A	G	1	3	4	0	0	4	0	0
7	16619272	.	A	G	8	43	51	1	0	52	0	0
7	16619450	.	A	G	11	2	13	0	0	13	0	0
7	16619714	.	A	G	65	20	85	0	2	87	0	0
7	16649396	.	A	T	261	31	292	8	29	329	0	0
7	16650306	.	C	G	10	16	26	0	5	31	0	0
7	16651118	.	A	G	2	2227	2229	15	23	2267	0	0
7	16728876	.	G	C	1	4	5	0	0	5	0	0
7	18873733	.	T	C	5	3	8	0	0	8	0	0
7	18874314	.	T	C	15	3	18	0	0	18	0	0
7	19638449	.	T	A	2	6	8	0	0	8	0	0
7	19638461	.	T	A	2	3	5	0	0	5	0	0
7	23840812	.	T	C	2	5	7	7	0	14	0	0
7	23933876	.	G	A	2	3	5	4	0	9	0	0
7	23974961	.	C	T	1	3	4	9	0	13	0	0
7	23974988	.	C	T	1	6	7	7	0	14	0	0
7	23975018	.	G	A	1	6	7	11	1	19	0	0
7	24710068	.	T	C	86	28	114	0	0	114	0	0
7	24710075	.	T	C	89	23	112	0	1	113	0	0
7	25370946	.	A	G	1	2	3	0	0	3	0	0
7	26904992	.	A	G	7	2	9	0	0	9	0	0
7	26905060	.	A	G	4	5	9	0	0	9	0	0
7	27520956	.	A	G	6	4	10	0	0	10	0	0
7	27521368	.	A	G	8	3	11	0	0	11	0	0
7	27663968	.	C	T	2	6	8	4	1	13	0	0
7	28922523	.	T	C	8	2	10	0	0	10	0	0
7	29664648	.	C	G	1	2	3	101	0	104	0	0
7	30126576	.	A	G	1	2	3	0	0	3	0	0
7	34746035	.	T	C	5	2	7	0	0	7	0	0
7	35090723	.	A	G	10	4	14	0	1	15	0	0
7	39238482	.	A	G	1	3	4	1	1	6	0	0
7	43174884	.	T	C	5	2	7	0	0	7	0	0
7	43954213	.	C	G	11	2	13	0	0	13	0	0
7	44698795	.	A	C	4	3	7	0	2	9	0	0
7	45032973	.	T	C	5	5	10	0	0	10	0	0
7	45141114	.	T	C	3	3	6	0	1	7	0	0
7	49205135	.	A	G	1	2	3	0	0	3	0	0
7	55627368	.	T	C	61	17	78	0	1	79	0	0
7	58900772	.	A	G	11	2	13	0	0	13	0	0
7	73388713	.	T	C	11	2	13	0	0	13	0	0
7	75403234	.	C	T	5	2	7	0	0	7	0	0
7	75403236	.	G	T	5	2	7	0	0	7	0	0
7	79574208	.	T	C	4	4	8	0	0	8	0	0
7	79574242	.	T	C	4	4	8	0	0	8	0	0
7	81522050	.	A	G	3	4	7	0	0	7	0	0
7	81522943	.	A	G	5	3	8	0	0	8	0	0
7	97339370	.	C	A	7	5	12	0	0	12	0	0
7	98966906	.	T	C	10	1	11	0	7	18	0	0
7	98966912	.	A	C	8	2	10	0	6	16	0	0
7	101561470	.	A	G	8	2	10	0	1	11	0	0
7	105399939	.	C	T	3	2	5	0	0	5	0	0
7	110655309	.	T	C	21	11	32	1	1	34	0	0
7	111914353	.	T	C	4	1	5	0	0	5	0	0
7	122793209	.	G	A	3	2	5	0	0	5	0	0
7	123582585	.	A	G	15	3	18	0	0	18	0	0
7	126389767	.	T	C	1	2	3	0	0	3	0	0
7	126853494	.	A	G	26	10	36	0	1	37	0	0
7	127178178	.	A	G	1	2	3	0	2	5	0	0
7	127519115	.	A	G	1	4	5	0	0	5	0	0
7	128385724	.	C	A	12	2	14	0	1	15	0	0
7	130360893	.	A	T	3	9	12	0	1	13	0	0
7	139715640	.	A	G	2	3	5	0	0	5	0	0
7	139716520	.	A	G	4	2	6	0	0	6	0	0
7	141503659	.	T	C	14	3	17	0	0	17	0	0
7	142207010	.	T	C	51	16	67	0	0	68	1	0
7	144133383	.	T	C	1	2	3	0	0	3	0	0
8	3589445	.	A	G	5	2	7	0	0	7	0	0
8	3589455	.	A	G	3	3	6	0	0	6	0	0
8	19732474	.	C	A	6	3	9	3	0	12	0	0
8	19737779	.	A	G	8	2	10	6	0	16	0	0
8	19737782	.	C	G	8	2	10	6	0	16	0	0
8	19741629	.	C	T	4	2	6	2	0	8	0	0
8	19747709	.	C	T	4	6	10	6	0	16	0	0
8	19747710	.	G	A	6	4	10	6	0	16	0	0
8	20030704	.	C	T	28	6	34	21	0	55	0	0
8	20030895	.	C	A	28	6	34	19	0	53	0	0
8	20030901	.	C	A	41	11	52	21	0	73	0	0
8	20698008	.	A	T	28	5	33	18	1	52	0	0
8	20727130	.	G	A	27	13	40	1	0	41	0	0
8	41370836	.	A	G	14	4	18	0	0	18	0	0
8	41370849	.	A	G	16	3	19	0	0	19	0	0
8	42700188	.	T	C	2	4	6	1	0	7	0	0
8	42700384	.	A	G	0	2	2	3	1	6	0	0
8	47546763	.	T	G	1	7	8	0	0	8	0	0
8	55134560	.	C	G	18	2	20	0	1	21	0	0
8	61848427	.	G	T	10	2	12	0	4	16	0	0
8	70007507	.	T	C	3	2	5	2	0	7	0	0
8	70017218	.	C	G	2	5	7	11	0	18	0	0
8	70017232	.	G	A	2	3	5	4	0	9	0	0
8	70017426	.	C	A	3	2	5	8	0	13	0	0
8	70037701	.	A	T	1	3	4	0	0	4	0	0
8	70463207	.	T	C	1	1	2	1	1	4	0	0
8	70846182	.	T	C	3	3	6	0	0	6	0	0
8	70846188	.	T	C	3	2	5	0	0	5	0	0
8	70847819	.	T	C	2	6	8	0	0	8	0	0
8	71153126	.	T	C	9	12	21	0	16	37	0	0
8	72687864	.	G	A	6	1	7	4	1	12	0	0
8	72687866	.	T	A	6	1	7	4	2	13	0	0
8	72977426	.	A	G	19	38	57	0	1	58	0	0
8	72977438	.	A	G	56	9	65	0	1	66	0	0
8	72977659	.	A	G	32	8	40	0	0	40	0	0
8	73269626	.	T	C	1	7	8	0	0	8	0	0
8	73269630	.	T	C	1	6	7	0	0	7	0	0
8	80784536	.	G	A	2	2	4	0	0	4	0	0
8	88685947	.	T	C	3	2	5	0	0	5	0	0
8	88898496	.	A	G	14	6	20	0	0	20	0	0
8	94743943	.	T	C	4	4	8	0	1	9	0	0
8	94879775	.	A	C	1	1	2	0	4	6	0	0
8	94879781	.	A	C	0	2	2	0	3	5	0	0
8	95632625	.	C	T	4	2	6	0	0	6	0	0
8	96177365	.	G	T	12	3	15	0	1	16	0	0
8	96177366	.	C	T	14	3	17	0	0	17	0	0
8	96468587	.	G	A	27	25	52	0	0	52	0	0
8	104986580	.	A	G	1	2	3	0	0	3	0	0
8	106064684	.	A	G	2	1	3	0	0	3	0	0
8	110435833	.	T	C	5	2	7	0	0	7	0	0
8	110817217	.	A	G	26	6	32	0	2	34	0	0
8	111731189	.	T	C	13	3	16	0	1	17	0	0
8	111731758	.	T	C	19	6	25	0	0	25	0	0
8	122566751	.	C	T	1	2	3	0	0	3	0	0
8	123198434	.	T	C	2	4	6	0	0	6	0	0
8	124261954	.	A	G	5	2	7	0	0	7	0	0
8	125620618	.	T	C	10	19	29	0	4	33	0	0
8	125620861	.	T	C	30	8	38	0	0	38	0	0
8	125620923	.	T	C	11	24	35	0	0	35	0	0
8	125620929	.	T	C	18	11	29	0	1	30	0	0
8	129979572	.	C	A	0	2	2	7	1	10	0	0
9	3387716	.	A	G	16	3	19	0	0	19	0	0
9	3387771	.	A	G	17	11	28	0	0	28	0	0
9	4456006	.	T	C	3	35	38	0	0	38	0	0
9	13756171	.	A	G	9	2	11	0	0	11	0	0
9	20357181	.	A	G	4	3	7	0	0	7	0	0
9	20511950	.	A	G	5	4	9	0	0	9	0	0
9	20511951	.	A	G	6	3	9	0	0	9	0	0
9	20513256	.	A	G	4	2	6	0	0	6	0	0
9	20515715	.	A	G	3	2	5	0	0	5	0	0
9	21044762	.	T	C	1	3	4	0	0	4	0	0
9	27260291	.	G	T	1	4	5	0	1	6	0	0
9	35477335	.	G	T	1	0	1	0	1	2	0	0
9	43133659	.	A	C	9	2	11	0	2	13	0	0
9	43957544	.	A	G	7	2	9	0	0	9	0	0
9	44005230	.	G	A	1	2	3	0	5	8	0	0
9	44204076	.	T	C	14	5	19	0	0	19	0	0
9	44221511	.	A	T	1	6	7	0	0	7	0	0
9	44529904	.	A	G	1	2	3	0	0	3	0	0
9	44715936	.	C	T	3	1	4	0	2	6	0	0
9	44715939	.	C	T	3	0	3	0	4	7	0	0
9	45747428	.	A	T	2	2	4	1	0	5	0	0
9	51534505	.	T	C	2	4	6	0	1	7	0	0
9	51534649	.	G	T	1	2	3	0	0	3	0	0
9	51535071	.	T	C	1	2	3	0	0	3	0	0
9	51535078	.	A	G	1	2	3	0	0	3	0	0
9	51914150	.	T	G	1	2	3	0	0	3	0	0
9	53311221	.	A	G	7	2	9	0	1	10	0	0
9	54275803	.	G	T	3	2	5	0	0	5	0	0
9	54275804	.	G	T	3	2	5	0	0	5	0	0
9	57449243	.	G	T	9	5	14	0	1	15	0	0
9	57449244	.	G	T	10	5	15	0	0	15	0	0
9	64142586	.	A	G	1	2	3	1	0	4	0	0
9	65253476	.	A	G	8	2	10	0	1	11	0	0
9	65595677	.	A	G	8	2	10	0	0	10	0	0
9	67127311	.	T	C	31	9	40	0	1	41	0	0
9	67892060	.	C	T	6	3	9	0	1	10	0	0
9	72270786	.	C	A	15	8	23	1	4	28	0	0
9	72381503	.	T	C	2	2	4	0	0	4	0	0
9	72635965	.	A	G	3	3	6	0	0	6	0	0
9	73004506	.	A	G	9	2	11	0	0	11	0	0
9	73387872	.	G	T	10	4	14	0	3	17	0	0
9	73387877	.	C	T	7	4	11	0	4	15	0	0
9	75550544	.	G	T	8	3	11	0	1	12	0	0
9	75550546	.	G	T	10	1	11	0	3	14	0	0
9	88329174	.	T	C	1	2	3	0	0	3	0	0
9	89794102	.	T	C	11	4	15	0	8	23	0	0
9	95284317	.	C	A	13	3	16	0	6	22	0	0
9	95939293	.	A	G	18	6	24	0	1	25	0	0
9	107436552	.	A	G	3	2	5	0	0	5	0	0
9	107640487	.	T	C	1	2	3	0	0	3	0	0
9	108215047	.	T	G	3	3	6	0	3	9	0	0
9	118754231	.	C	G	10	6	16	0	1	17	0	0
9	122725342	.	A	G	5	2	7	0	0	7	0	0
9	124034094	.	A	G	22	8	30	0	0	30	0	0
X	7773818	.	A	G	8	2	10	0	1	11	0	0
X	37698807	.	A	G	7	2	9	0	0	9	0	0
X	40743165	.	A	G	1	12	13	0	0	13	0	0
X	47457548	.	A	C	6	2	8	0	0	8	0	0
X	52045173	.	C	T	9	2	11	0	1	12	0	0
X	55633003	.	T	C	35	9	44	0	0	44	0	0
X	55695874	.	A	G	1	3	4	0	0	4	0	0
X	56429832	.	C	A	16	3	19	0	4	23	0	0
X	56433180	.	C	T	6	2	8	0	0	8	0	0
X	60231705	.	A	G	7	11	18	0	0	18	0	0
X	60829523	.	G	A	1	2	3	10	0	13	0	0
X	61819787	.	T	A	3	1	4	5	1	10	0	0
X	70335535	.	G	A	3	2	5	0	0	5	0	0
X	73270255	.	T	C	7	4	11	0	0	11	0	0
X	73270468	.	T	C	9	10	19	0	0	19	0	0
X	73328498	.	A	G	4	2	6	0	1	7	0	0
X	73328516	.	A	G	5	2	7	0	0	7	0	0
X	73328787	.	A	G	2	3	5	0	0	5	0	0
X	73328821	.	A	G	4	2	6	0	0	6	0	0
X	93771606	.	T	C	3	2	5	0	0	5	0	0
X	94092763	.	G	C	18	5	23	0	6	29	0	0
X	94092768	.	A	C	24	5	29	0	2	31	0	0
X	102620099	.	T	C	3	11	14	0	0	14	0	0
X	102620158	.	T	C	2	9	11	0	0	11	0	0
X	102620159	.	T	C	2	9	11	0	0	11	0	0
X	102623385	.	T	C	7	4	11	0	3	14	0	0
X	102623421	.	T	C	8	2	10	0	0	10	0	0
X	103389699	.	G	A	0	4	4	2	2	8	0	0
X	103389705	.	T	A	3	0	3	30	2	35	0	0
X	105976011	.	T	C	1	2	3	0	0	3	0	0
X	106830700	.	T	C	49	8	57	0	1	58	0	0
X	133489300	.	T	C	8	4	12	0	0	12	0	0
X	133489379	.	T	C	5	5	10	0	0	10	0	0
X	133489405	.	T	C	9	3	12	0	0	12	0	0
X	133490041	.	T	C	8	2	10	0	0	10	0	0
X	133490101	.	T	C	8	2	10	0	0	10	0	0
X	133490145	.	T	C	8	3	11	0	0	11	0	0
X	133505363	.	C	A	2	1	3	0	1	4	0	0
X	140507620	.	T	C	2	3	5	0	0	5	0	0
X	145978689	.	A	G	66	20	86	0	4	90	0	0
X	149766871	.	T	C	28	6	34	0	5	39	0	0
X	149767260	.	T	C	174	28	202	0	2	204	0	0
X	149767614	.	T	C	82	77	159	1	7	167	0	0
X	149768450	.	T	C	180	42	222	0	2	224	0	0
X	149768519	.	T	C	225	35	260	0	2	262	0	0
X	149768525	.	T	C	144	94	238	0	5	243	0	0
X	164972992	.	A	G	8	2	10	4	0	14	0	0
Y	1016394	.	A	G	14	10	24	0	0	24	0	0
Y	1048726	.	A	G	3	2	5	0	0	5	0	0
