contig	position	variantID	refAllele	altAllele	refCount	altCount	totalCount	lowMAPQDepth	lowBaseQDepth	rawDepth	otherBases	improperPairs
1	8432314	.	A	G	7	2	9	0	0	9	0	0
1	12875508	.	G	T	12	2	14	0	1	15	0	0
1	13695965	.	T	C	2	2	4	4	0	8	0	0
1	13696013	.	T	C	4	2	6	6	0	12	0	0
1	16717060	.	T	C	8	7	15	0	0	15	0	0
1	22031785	.	T	C	5	10	15	0	0	15	0	0
1	36405381	.	T	C	5	2	7	0	0	7	0	0
1	36577688	.	T	C	11	2	13	0	0	13	0	0
1	37448671	.	G	T	4	3	7	0	2	9	0	0
1	39696041	.	A	G	6	2	8	0	0	8	0	0
1	42736417	.	G	A	1	2	3	0	1	4	0	0
1	42739790	.	C	T	3	4	7	0	2	9	0	0
1	51507771	.	T	C	1	2	3	0	0	3	0	0
1	52224672	.	G	A	4	3	7	0	0	7	0	0
1	57079608	.	T	C	9	2	11	0	0	11	0	0
1	57982191	.	A	C	10	12	22	0	1	23	0	0
1	58425292	.	T	C	6	2	8	0	0	8	0	0
1	59756998	.	A	G	12	2	14	0	0	14	0	0
1	59913367	.	A	G	49	18	67	0	0	67	0	0
1	60517747	.	A	G	32	17	49	0	6	55	0	0
1	64072020	.	C	T	1	2	3	0	1	4	0	0
1	65314871	.	G	T	14	1	15	0	1	16	0	0
1	65314876	.	G	T	13	2	15	0	1	16	0	0
1	66711873	.	A	G	89	46	135	0	5	140	0	0
1	75398649	.	A	G	19	5	24	0	1	25	0	0
1	75398708	.	A	G	3	16	19	0	3	22	0	0
1	79681738	.	G	T	7	3	10	0	0	10	0	0
1	79681745	.	G	T	6	2	8	0	0	8	0	0
1	82214734	.	A	G	3	2	5	0	0	5	0	0
1	84883650	.	T	C	10	2	12	0	1	13	0	0
1	86205422	.	A	G	3	2	5	0	0	5	0	0
1	86272932	.	T	C	9	2	11	0	0	11	0	0
1	86272992	.	T	C	12	2	14	0	0	14	0	0
1	86273633	.	T	C	10	15	25	0	0	25	0	0
1	86273638	.	T	C	17	6	23	0	0	23	0	0
1	86275650	.	T	C	20	3	23	0	0	23	0	0
1	86276528	.	T	C	13	5	18	0	0	18	0	0
1	88188150	.	C	A	1	2	3	0	0	3	0	0
1	88189707	.	C	T	2	3	5	0	0	5	0	0
1	88189784	.	A	G	1	2	3	0	0	3	0	0
1	88190921	.	C	T	1	4	5	0	0	5	0	0
1	88191018	.	A	T	4	9	13	0	0	13	0	0
1	88191035	.	T	A	2	11	13	0	0	13	0	0
1	88191237	.	A	C	13	25	38	0	3	41	0	0
1	88191281	.	A	G	36	7	43	0	3	46	0	0
1	88191311	.	T	C	5	42	47	0	0	47	0	0
1	88191320	.	C	T	16	28	44	0	2	46	0	0
1	88191706	.	G	A	26	7	33	0	0	33	0	0
1	88191710	.	T	C	15	16	31	0	0	31	0	0
1	88191744	.	C	A	20	5	25	0	0	25	0	0
1	88191864	.	G	T	30	11	41	0	1	42	0	0
1	88192008	.	C	T	46	13	59	0	3	62	0	0
1	88192037	.	T	A	3	24	27	0	0	27	0	0
1	88192048	.	G	C	9	32	41	0	0	41	0	0
1	88192098	.	G	A	45	8	53	0	1	54	0	0
1	88192180	.	G	T	46	8	54	0	4	58	0	0
1	88192184	.	T	A	50	10	60	0	1	61	0	0
1	88192243	.	A	G	11	20	31	0	1	32	0	0
1	88192700	.	G	A	7	23	30	0	2	32	0	0
1	88192756	.	G	A	8	23	31	0	1	32	0	0
1	88192844	.	G	A	3	19	22	0	0	22	0	0
1	88193031	.	C	G	11	9	20	0	0	20	0	0
1	88193194	.	C	T	3	4	7	3	0	10	0	0
1	88193568	.	A	C	1	3	4	40	0	44	0	0
1	88193917	.	G	A	5	13	18	12	0	30	0	0
1	88194314	.	C	A	33	6	39	0	1	40	0	0
1	88197053	.	T	C	12	24	36	0	0	36	0	0
1	88197991	.	A	G	5	30	35	0	1	36	0	0
1	88197996	.	C	T	4	32	36	0	0	36	0	0
1	88200670	.	G	A	1	12	13	0	0	13	0	0
1	88200718	.	C	A	1	5	6	0	0	6	0	0
1	88200832	.	C	T	2	9	11	0	0	11	0	0
1	88202664	.	A	G	1	2	3	2	0	5	0	0
1	88203670	.	C	T	1	1	2	1	1	4	0	0
1	88204960	.	T	C	2	9	11	2	0	13	0	0
1	118225697	.	T	C	6	2	8	0	0	8	0	0
1	126309860	.	C	G	2	1	3	0	0	3	0	0
1	131953439	.	T	C	14	8	22	0	1	23	0	0
1	133065748	.	A	G	25	6	31	0	1	32	0	0
1	143625283	.	A	G	12	3	15	0	0	15	0	0
1	152998603	.	C	T	7	2	9	0	0	9	0	0
1	153125446	.	A	G	7	2	9	0	0	9	0	0
1	155151508	.	G	T	11	5	16	0	7	23	0	0
1	155151509	.	C	T	13	2	15	0	9	24	0	0
1	156255182	.	T	C	4	16	20	0	0	20	0	0
1	156255601	.	T	C	5	2	7	0	0	7	0	0
1	156468972	.	C	G	1	3	4	0	1	5	0	0
1	159759023	.	G	A	10	7	17	0	13	30	0	0
1	160842749	.	T	C	6	2	8	0	0	8	0	0
1	162425767	.	A	G	38	6	44	0	2	46	0	0
1	165058782	.	T	C	4	4	8	0	0	8	0	0
1	165058785	.	T	C	3	4	7	0	0	7	0	0
1	167982598	.	C	T	10	3	13	0	5	18	0	0
1	178779916	.	T	C	8	2	10	0	0	10	0	0
1	180924020	.	T	C	16	6	22	0	1	23	0	0
1	183190594	.	A	G	10	4	14	0	1	15	0	0
1	191633802	.	T	C	1	2	3	0	0	3	0	0
1	191642234	.	C	T	7	2	9	0	10	19	0	0
10	7524278	.	T	C	5	2	7	0	0	7	0	0
10	9500826	.	C	T	7	2	9	0	0	9	0	0
10	11333810	.	C	T	18	6	24	0	4	28	0	0
10	11333814	.	C	T	21	3	24	0	6	30	0	0
10	14621524	.	C	T	4	5	9	132	0	141	0	0
10	14621525	.	C	T	7	2	9	136	0	145	0	0
10	20194372	.	A	G	4	2	6	0	0	6	0	0
10	20194416	.	A	G	1	3	4	0	0	4	0	0
10	33685021	.	C	G	4	2	6	0	0	6	0	0
10	33868473	.	T	C	4	11	15	0	0	15	0	0
10	49118546	.	T	C	10	2	12	0	0	12	0	0
10	49118584	.	T	C	6	9	15	0	1	16	0	0
10	49118640	.	T	C	7	3	10	0	0	10	0	0
10	49120426	.	T	C	6	25	31	0	3	34	0	0
10	49148872	.	T	C	4	36	40	0	0	40	0	0
10	49148885	.	T	C	5	24	29	0	0	29	0	0
10	57383252	.	A	G	3	2	5	0	0	5	0	0
10	57383263	.	A	G	3	2	5	0	0	5	0	0
10	57391874	.	C	T	10	3	13	0	1	14	0	0
10	73038538	.	A	G	1	2	3	0	0	3	0	0
10	76391424	.	A	G	7	2	9	0	0	9	0	0
10	77158441	.	T	C	14	47	61	1	2	64	0	0
10	77158455	.	T	C	37	23	60	1	0	61	0	0
10	79593391	.	A	G	3	2	5	0	0	5	0	0
10	79593482	.	A	G	5	2	7	0	0	7	0	0
10	80403193	.	T	C	54	11	65	0	0	65	0	0
10	81557874	.	C	T	1	2	3	1	0	4	0	0
10	88309398	.	G	A	5	2	7	0	0	7	0	0
10	89654262	.	C	A	12	6	18	0	5	23	0	0
10	93800442	.	T	C	4	3	7	0	0	7	0	0
10	93801873	.	T	C	11	2	13	0	0	13	0	0
10	94057224	.	A	G	8	8	16	0	0	16	0	0
10	94057234	.	A	G	9	3	12	0	0	12	0	0
10	109518521	.	G	T	18	8	26	0	4	30	0	0
10	122829334	.	T	G	2	1	3	0	2	5	0	0
10	126903751	.	T	C	78	11	89	0	1	90	0	0
10	127113859	.	T	C	5	2	7	0	0	7	0	0
10	128031996	.	A	G	2	2	4	0	0	4	0	0
10	128032031	.	A	G	2	2	4	0	0	4	0	0
10	128032764	.	A	G	2	3	5	0	0	5	0	0
10	128720102	.	A	C	5	2	7	0	5	12	0	0
10	128720108	.	A	C	6	1	7	0	4	11	0	0
10	128754412	.	A	G	1	1	2	0	1	3	0	0
11	3137367	.	T	C	10	2	12	0	0	12	0	0
11	3257244	.	T	C	5	2	7	0	0	7	0	0
11	4092046	.	T	C	16	9	25	0	0	25	0	0
11	5919668	.	A	T	5	2	7	0	0	7	0	0
11	43572939	.	A	G	5	4	9	0	0	9	0	0
11	43574977	.	A	G	2	3	5	0	0	5	0	0
11	46163470	.	T	C	83	376	459	0	9	468	0	0
11	48643891	.	G	A	0	2	2	1	1	4	0	0
11	48691187	.	C	T	14	6	20	0	0	20	0	0
11	50272063	.	C	T	8	3	11	0	6	17	0	0
11	51632004	.	A	G	1	2	3	0	0	3	0	0
11	54730814	.	T	C	11	3	14	0	0	14	0	0
11	59347027	.	A	G	28	14	42	0	1	43	0	0
11	59347029	.	A	G	35	9	44	0	0	44	0	0
11	59347072	.	A	G	22	7	29	0	0	29	0	0
11	59349201	.	A	G	15	6	21	0	0	21	0	0
11	59401881	.	A	G	4	2	6	0	1	7	0	0
11	59678220	.	A	G	1	1	2	0	1	3	0	0
11	60623200	.	C	T	4	2	6	0	2	8	0	0
11	62293504	.	T	A	11	2	13	0	0	13	0	0
11	69922901	.	A	G	6	8	14	0	0	14	0	0
11	69922950	.	A	G	5	4	9	0	2	11	0	0
11	69925810	.	A	G	2	2	4	0	0	4	0	0
11	69926003	.	A	G	13	2	15	0	0	15	0	0
11	69926817	.	A	G	6	3	9	0	1	10	0	0
11	69927869	.	A	G	2	4	6	0	1	7	0	0
11	69927946	.	A	G	6	5	11	0	0	11	0	0
11	69927953	.	A	G	9	3	12	0	0	12	0	0
11	69928014	.	A	G	4	3	7	0	0	7	0	0
11	69937302	.	A	G	5	1	6	0	2	8	0	0
11	69937661	.	T	C	11	2	13	0	0	13	0	0
11	72816636	.	T	A	7	2	9	0	1	10	0	0
11	75067170	.	T	C	15	5	20	0	3	23	0	0
11	75067171	.	T	C	18	3	21	0	3	24	0	0
11	75067258	.	T	C	33	11	44	0	0	44	0	0
11	75068177	.	T	C	27	3	30	0	1	31	0	0
11	75068297	.	T	C	25	4	29	0	0	29	0	0
11	77426880	.	T	C	36	7	43	0	1	44	0	0
11	78187443	.	A	G	3	3	6	0	0	6	0	0
11	78187460	.	A	G	3	2	5	0	0	5	0	0
11	78187512	.	A	G	3	2	5	0	0	5	0	0
11	78388363	.	G	A	5	4	9	0	1	10	0	0
11	78459018	.	A	T	36	1	37	0	5	42	0	0
11	78459020	.	G	T	34	3	37	0	5	42	0	0
11	78736472	.	A	G	2	5	7	0	0	7	0	0
11	78736647	.	A	G	11	3	14	0	0	14	0	0
11	83978221	.	T	C	1	2	3	0	0	3	0	0
11	86521333	.	T	C	1	5	6	2	0	8	0	0
11	86521517	.	A	G	2	1	3	1	2	6	0	0
11	87014114	.	A	G	10	3	13	0	0	13	0	0
11	88083921	.	T	C	3	2	5	0	0	5	0	0
11	88230634	.	A	G	14	5	19	41	0	60	0	0
11	88230979	.	G	A	13	3	16	0	6	22	0	0
11	88927189	.	T	C	16	3	19	0	0	19	0	0
11	88927208	.	T	C	11	11	22	0	0	22	0	0
11	94431318	.	T	C	14	9	23	0	0	23	0	0
11	94431502	.	T	C	4	3	7	0	0	7	0	0
11	94431842	.	T	C	8	4	12	0	0	12	0	0
11	94432839	.	T	C	11	2	13	0	1	14	0	0
11	94432859	.	T	C	14	2	16	0	0	16	0	0
11	95722839	.	G	C	5	5	10	0	1	11	0	0
11	95722841	.	A	C	6	4	10	0	1	11	0	0
11	95938019	.	A	G	3	2	5	0	0	5	0	0
11	95962488	.	T	C	8	4	12	0	0	12	0	0
11	97598717	.	A	G	2	2	4	0	0	4	0	0
11	98044632	.	A	C	9	2	11	0	7	18	0	0
11	98044638	.	A	C	12	2	14	0	3	17	0	0
11	98736061	.	A	G	9	2	11	0	0	11	0	0
11	99569928	.	G	A	1	1	2	0	1	3	0	0
11	100329322	.	T	C	4	2	6	0	0	6	0	0
11	101080710	.	A	C	11	4	15	0	2	17	0	0
11	101080714	.	G	C	14	4	18	0	5	23	0	0
11	101089126	.	T	C	7	3	10	0	0	10	0	0
11	101089557	.	T	C	13	6	19	0	0	19	0	0
11	101089588	.	T	C	10	2	12	0	1	13	0	0
11	101089734	.	T	C	7	3	10	0	0	10	0	0
11	101089802	.	T	C	9	5	14	0	1	15	0	0
11	105879428	.	G	T	8	2	10	0	0	10	0	0
11	105879986	.	A	C	4	2	6	0	3	9	0	0
11	107578937	.	C	T	7	2	9	0	2	11	0	0
11	107578938	.	C	T	8	2	10	0	1	11	0	0
11	115534972	.	A	T	16	7	23	0	16	39	0	0
11	116013650	.	T	C	1	4	5	0	0	5	0	0
11	116303813	.	T	C	17	4	21	0	0	21	0	0
11	116471963	.	T	C	12	27	39	0	2	41	0	0
11	118309834	.	C	G	9	2	11	0	0	11	0	0
12	3454248	.	A	G	13	43	56	10	3	69	0	0
12	17479431	.	G	C	7	7	14	1	3	18	0	0
12	17479809	.	A	G	9	12	21	0	0	21	0	0
12	17479860	.	A	G	10	4	14	0	0	14	0	0
12	38917612	.	A	C	23	6	29	0	4	33	0	0
12	38917619	.	A	C	20	4	24	0	2	26	0	0
12	46747117	.	T	C	30	18	48	0	0	48	0	0
12	49453785	.	G	A	6	3	9	0	1	10	0	0
12	54718540	.	T	C	21	7	28	0	0	28	0	0
12	54719142	.	T	C	26	4	30	0	1	31	0	0
12	55102739	.	T	C	3	2	5	0	1	6	0	0
12	65091728	.	A	G	1	2	3	0	0	3	0	0
12	65091799	.	A	G	3	1	4	0	1	5	0	0
12	65091803	.	A	G	4	2	6	0	0	6	0	0
12	65113982	.	T	C	3	5	8	0	0	8	0	0
12	69244102	.	A	G	7	3	10	0	0	10	0	0
12	71041403	.	A	G	7	31	38	0	0	38	0	0
12	71041945	.	A	G	17	7	24	0	2	26	0	0
12	71041954	.	A	G	17	16	33	0	2	35	0	0
12	71041984	.	A	G	22	13	35	0	0	35	0	0
12	72842800	.	C	T	17	4	21	0	15	36	0	0
12	72956113	.	T	C	8	2	10	0	0	10	0	0
12	73975614	.	A	G	4	3	7	0	0	7	0	0
12	75677928	.	A	G	1	2	3	1	1	5	0	0
12	80769472	.	A	G	1	2	3	0	0	3	0	0
12	80769473	.	A	G	1	2	3	0	0	3	0	0
12	80769525	.	A	G	2	2	4	0	0	4	0	0
12	84969484	.	T	C	2	2	4	0	0	4	0	0
12	85389418	.	T	G	3	6	9	0	1	10	0	0
12	99162339	.	T	A	9	2	11	0	6	17	0	0
12	100837974	.	A	G	5	2	7	0	0	7	0	0
12	102748591	.	A	T	6	1	7	0	3	10	0	0
12	104378737	.	C	G	8	2	10	5	1	16	0	0
12	108171831	.	C	G	3	5	8	0	1	9	0	0
12	108993691	.	A	G	7	2	9	0	1	10	0	0
12	109511197	.	C	A	19	3	22	0	20	42	0	0
12	109511202	.	C	A	6	20	26	0	10	36	0	0
12	109552521	.	A	G	4	4	8	0	0	8	0	0
12	109706996	.	A	G	8	2	10	0	1	11	0	0
12	112571040	.	G	C	1	7	8	0	1	9	0	0
12	112571046	.	A	C	1	6	7	0	1	8	0	0
13	5918220	.	T	C	10	3	13	1	9	23	0	0
13	8901801	.	T	C	13	4	17	1	0	18	0	0
13	14176133	.	T	C	4	2	6	0	0	6	0	0
13	14225628	.	T	C	22	9	31	0	1	32	0	0
13	14226674	.	T	C	41	9	50	0	0	50	0	0
13	14228102	.	T	C	18	7	25	0	0	25	0	0
13	15989053	.	T	C	1	2	3	0	0	3	0	0
13	17978854	.	T	C	12	2	14	0	0	14	0	0
13	17978950	.	T	C	3	5	8	0	0	8	0	0
13	17979133	.	T	C	5	9	14	0	1	15	0	0
13	21576512	.	T	C	7	7	14	0	0	14	0	0
13	21576591	.	T	C	7	3	10	0	0	10	0	0
13	21576611	.	T	C	14	6	20	0	0	20	0	0
13	24999535	.	A	G	3	3	6	0	0	6	0	0
13	24999573	.	A	G	2	3	5	0	0	5	0	0
13	25085252	.	T	A	9	0	9	0	7	17	1	0
13	25085253	.	G	A	10	3	13	0	4	17	0	0
13	25389897	.	T	C	5	2	7	0	0	7	0	0
13	30894440	.	C	A	8	6	14	0	1	15	0	0
13	34142594	.	A	T	11	2	13	0	0	13	0	0
13	57576501	.	T	G	12	3	15	0	7	22	0	0
13	59757011	.	A	G	1	3	4	0	0	4	0	0
13	63448526	.	A	G	6	2	8	0	0	8	0	0
13	64437994	.	T	C	11	3	14	0	0	14	0	0
13	64438124	.	T	C	8	6	14	0	0	14	0	0
13	64438165	.	T	C	9	2	11	0	0	11	0	0
13	65214229	.	G	A	8	4	12	0	0	12	0	0
13	67621181	.	T	C	3	4	7	0	0	7	0	0
13	67621265	.	T	C	5	8	13	0	0	13	0	0
13	67621455	.	T	C	3	5	8	1	0	9	0	0
13	67621510	.	T	C	7	3	10	0	2	12	0	0
13	67967765	.	T	C	1	2	3	0	0	3	0	0
13	74508407	.	A	G	7	4	11	0	0	11	0	0
13	78347093	.	A	C	4	2	6	0	3	9	0	0
13	92032478	.	A	C	11	5	16	0	2	18	0	0
13	92032483	.	A	C	9	3	12	0	3	15	0	0
13	107861323	.	C	T	8	6	14	0	4	18	0	0
13	110088083	.	A	C	5	2	7	0	2	9	0	0
13	110088088	.	A	C	5	2	7	0	2	9	0	0
13	119625401	.	G	T	20	6	26	0	1	27	0	0
13	120231029	.	A	C	0	0	0	0	3	3	0	0
14	10058181	.	A	G	114	30	144	0	1	145	0	0
14	14533725	.	T	C	3	11	14	0	2	16	0	0
14	20517408	.	T	C	4	4	8	0	0	8	0	0
14	21846596	.	C	T	13	15	28	1	14	43	0	0
14	21846832	.	A	G	20	29	49	0	0	49	0	0
14	21846833	.	A	G	41	7	48	0	1	49	0	0
14	21847779	.	A	G	49	15	64	0	1	65	0	0
14	26382041	.	A	G	8	2	10	0	0	10	0	0
14	26643098	.	T	C	10	2	12	0	2	14	0	0
14	29788070	.	T	C	16	4	20	0	0	20	0	0
14	29788078	.	T	C	15	7	22	0	1	23	0	0
14	30698016	.	A	G	1	3	4	0	0	4	0	0
14	31422583	.	T	C	31	10	41	0	0	41	0	0
14	32018582	.	A	G	28	11	39	0	0	39	0	0
14	45595722	.	A	G	1	2	3	0	0	3	0	0
14	47559730	.	A	T	10	2	12	4	5	23	2	0
14	52531673	.	A	G	64	9	73	0	1	74	0	0
14	52531686	.	A	G	18	56	74	0	0	74	0	0
14	55658167	.	A	G	1	2	3	0	0	3	0	0
14	55749057	.	A	G	8	2	10	0	0	10	0	0
14	55824926	.	C	T	3	2	5	1	0	6	0	0
14	58064703	.	G	T	3	2	5	0	1	6	0	0
14	60449378	.	T	C	2	2	4	0	0	4	0	0
14	62930576	.	A	G	5	2	7	0	0	7	0	0
14	63194559	.	G	T	7	3	10	0	1	11	0	0
14	65434640	.	T	C	29	20	49	0	0	49	0	0
14	67978970	.	C	T	5	1	6	0	1	7	0	0
14	67978973	.	A	T	6	0	6	0	2	8	0	0
14	70838843	.	T	C	6	2	8	0	0	8	0	0
14	70838850	.	T	C	7	1	8	0	0	8	0	0
14	87654117	.	C	T	7	2	9	0	0	9	0	0
14	101681499	.	G	A	5	1	6	0	0	6	0	0
14	101681500	.	C	T	5	1	6	0	0	6	0	0
14	103584115	.	T	C	21	20	41	0	1	42	0	0
14	109148057	.	C	G	16	8	24	0	3	27	0	0
14	119113824	.	G	A	7	3	10	0	2	12	0	0
14	121273016	.	A	G	7	8	15	0	0	15	0	0
14	122602972	.	A	C	6	2	8	0	0	8	0	0
14	123864295	.	C	T	15	11	26	0	1	27	0	0
15	8187674	.	A	G	3	4	7	0	0	7	0	0
15	8188973	.	A	G	1	4	5	0	1	6	0	0
15	9199559	.	A	G	30	13	43	0	2	45	0	0
15	34440663	.	A	G	1	2	3	0	0	3	0	0
15	55118295	.	A	G	13	4	17	0	0	17	0	0
15	55118692	.	A	G	12	8	20	0	0	20	0	0
15	66158075	.	T	C	15	4	19	0	0	19	0	0
15	76316680	.	A	G	1	2	3	0	0	3	0	0
15	76426173	.	A	G	3	2	5	0	0	5	0	0
15	78900113	.	T	C	7	4	11	0	0	11	0	0
15	79571382	.	G	A	31	8	39	1	5	45	0	0
15	80815257	.	C	T	13	2	15	0	3	18	0	0
15	81339166	.	A	G	6	5	11	0	0	11	0	0
15	81700884	.	A	G	11	2	13	0	0	13	0	0
15	81856599	.	T	A	2	2	4	1	1	6	0	0
15	82693738	.	C	T	4	1	5	0	2	7	0	0
15	93388677	.	C	G	6	2	8	0	7	15	0	0
15	93388679	.	A	G	9	3	12	0	5	17	0	0
15	97642749	.	G	A	5	1	6	0	0	6	0	0
15	98634993	.	T	C	12	28	40	0	2	42	0	0
15	98634994	.	T	C	32	6	38	0	5	43	0	0
15	98731431	.	T	C	25	5	30	0	1	31	0	0
15	98761570	.	T	G	11	3	14	0	0	14	0	0
15	98932415	.	C	T	1	2	3	162	0	165	0	0
15	98935332	.	C	T	1	2	3	188	0	191	0	0
15	99142536	.	T	C	59	19	78	18	1	97	0	0
15	99306430	.	A	C	37	8	45	0	1	46	0	0
15	99626091	.	A	G	6	2	8	0	0	8	0	0
15	99627261	.	A	G	6	3	9	0	0	9	0	0
15	102147263	.	T	A	4	2	6	0	0	6	0	0
16	3680985	.	T	C	14	2	16	0	1	17	0	0
16	3907278	.	T	C	2	2	4	0	0	4	0	0
16	4444240	.	T	C	2	3	5	0	0	5	0	0
16	4444284	.	T	C	4	2	6	0	0	6	0	0
16	5001983	.	T	C	6	2	8	0	0	8	0	0
16	8452432	.	T	C	14	3	17	0	0	17	0	0
16	13283445	.	A	G	1	1	2	0	1	3	0	0
16	13520445	.	A	G	19	4	23	0	0	23	0	0
16	13520501	.	A	G	18	3	21	0	0	21	0	0
16	13650548	.	T	C	1	2	3	1	0	4	0	0
16	13651812	.	T	C	8	3	11	0	0	11	0	0
16	13651888	.	T	C	10	3	13	0	1	14	0	0
16	16844952	.	A	G	5	2	7	0	0	7	0	0
16	17321752	.	A	G	10	5	15	0	0	15	0	0
16	18653678	.	A	G	39	9	48	0	1	49	0	0
16	19942498	.	A	G	37	19	56	0	3	59	0	0
16	20363189	.	A	G	4	2	6	0	0	6	0	0
16	32119150	.	A	G	13	17	30	0	0	30	0	0
16	32209076	.	C	T	9	4	13	0	2	15	0	0
16	33790130	.	T	C	18	3	21	0	0	21	0	0
16	38319163	.	G	A	0	2	2	0	5	7	0	0
16	38319167	.	G	A	0	1	1	0	3	4	0	0
16	55828700	.	A	T	8	2	10	0	3	13	0	0
16	55828701	.	A	T	10	3	13	0	4	17	0	0
16	55837428	.	G	A	14	13	27	2	20	49	0	0
16	62591151	.	T	C	5	1	6	0	0	6	0	0
16	76086789	.	G	T	13	2	15	0	4	19	0	0
16	76086791	.	C	T	14	1	15	0	5	20	0	0
16	81420648	.	G	T	24	5	29	0	6	35	0	0
16	81420650	.	C	T	26	3	29	0	5	35	1	0
16	87230813	.	T	C	7	3	10	0	0	10	0	0
16	87230814	.	T	C	6	4	10	0	0	10	0	0
16	87737431	.	T	C	5	7	12	0	0	12	0	0
16	91287590	.	A	G	3	2	5	0	0	5	0	0
16	91287619	.	A	G	2	1	3	0	1	4	0	0
16	91452977	.	A	G	55	36	91	0	0	91	0	0
16	91453021	.	A	G	67	18	85	0	0	85	0	0
16	91880602	.	G	T	10	8	18	1	2	21	0	0
17	6330894	.	T	C	25	6	31	13	0	44	0	0
17	10429111	.	C	T	6	4	10	0	0	10	0	0
17	15695826	.	T	C	2	3	5	0	0	5	0	0
17	15741073	.	A	G	5	2	7	0	0	7	0	0
17	15741577	.	A	G	4	3	7	0	0	7	0	0
17	15741583	.	A	G	3	3	6	0	0	7	1	0
17	15742482	.	A	G	1	3	4	0	0	4	0	0
17	15742489	.	A	G	2	2	4	0	0	4	0	0
17	15742534	.	A	G	5	2	7	0	0	7	0	0
17	17679292	.	C	T	14	3	17	0	7	24	0	0
17	18050496	.	A	G	2	2	4	0	0	4	0	0
17	18051016	.	C	T	1	2	3	0	0	3	0	0
17	18051017	.	G	T	1	2	3	0	0	3	0	0
17	24395416	.	T	C	50	8	58	0	1	59	0	0
17	24395428	.	T	C	60	16	76	0	1	77	0	0
17	24397285	.	T	C	23	13	36	0	0	36	0	0
17	24397327	.	T	C	8	13	21	0	1	22	0	0
17	27798365	.	C	T	3	2	5	0	0	5	0	0
17	27929098	.	A	C	108	70	178	0	24	202	0	0
17	28280314	.	A	C	16	2	18	0	6	24	0	0
17	28280320	.	G	C	19	5	24	0	4	28	0	0
17	28811645	.	T	C	4	2	6	0	0	6	0	0
17	31559935	.	T	C	5	2	7	0	0	7	0	0
17	33015057	.	T	C	13	2	15	0	0	15	0	0
17	33015107	.	T	C	2	8	10	0	0	10	0	0
17	33015546	.	T	C	11	3	14	0	0	14	0	0
17	33034549	.	T	C	6	2	8	0	1	9	0	0
17	33038156	.	T	C	10	7	17	0	0	17	0	0
17	33038160	.	T	C	10	8	18	0	0	18	0	0
17	33550719	.	T	C	14	4	18	0	0	18	0	0
17	33552004	.	T	C	7	7	14	0	0	14	0	0
17	33906273	.	T	C	7	5	12	0	0	12	0	0
17	34147531	.	A	G	19	3	22	0	0	22	0	0
17	34891011	.	C	G	1	1	2	0	0	2	0	0
17	35347738	.	T	C	2	1	3	0	3	6	0	0
17	36168626	.	A	G	7	3	10	0	1	11	0	0
17	36169789	.	A	G	3	3	6	0	0	6	0	0
17	36169794	.	A	G	4	2	6	0	0	6	0	0
17	36241623	.	A	T	19	2	21	1	1	23	0	0
17	36316655	.	T	C	10	2	12	0	1	13	0	0
17	36580351	.	T	C	6	2	8	0	0	8	0	0
17	36580955	.	T	C	5	2	7	0	0	7	0	0
17	40158498	.	T	C	3613	4606	8219	85	144	8828	380	0
17	40159543	.	T	C	37	247	284	1	6	291	0	0
17	43767562	.	A	C	2	1	3	0	1	4	0	0
17	43767568	.	A	C	1	2	3	0	1	4	0	0
17	45973875	.	T	C	34	76	110	0	4	114	0	0
17	46727251	.	A	G	2	3	5	0	0	5	0	0
17	47085856	.	T	C	19	7	26	0	0	26	0	0
17	52159353	.	A	G	3	3	6	0	0	6	0	0
17	52166231	.	A	G	1	3	4	0	0	4	0	0
17	65887642	.	G	A	149	39	188	4	19	211	0	0
17	66424296	.	G	C	5	2	7	0	2	9	0	0
17	66424299	.	T	C	5	2	7	0	1	8	0	0
17	78682975	.	G	T	6	3	9	0	0	9	0	0
17	78682979	.	G	T	3	3	6	0	0	6	0	0
17	86962445	.	G	A	70	21	91	0	5	96	0	0
17	95064343	.	T	C	13	3	16	0	0	16	0	0
17	95064364	.	T	C	6	2	8	0	0	8	0	0
17	95067396	.	T	C	12	9	21	0	0	21	0	0
17	95068552	.	T	C	29	8	37	0	0	37	0	0
17	95123373	.	T	C	3	2	5	0	0	5	0	0
17	95123375	.	T	C	3	1	4	0	1	5	0	0
17	95183584	.	T	C	1	2	3	0	0	3	0	0
17	95183592	.	A	G	2	3	5	0	0	5	0	0
18	4198498	.	C	T	1	3	4	7	0	11	0	0
18	6792739	.	A	G	15	6	21	0	0	21	0	0
18	6792757	.	A	G	14	6	20	0	0	20	0	0
18	6792802	.	A	G	13	7	20	0	0	20	0	0
18	6792826	.	A	G	17	5	22	0	0	22	0	0
18	6793746	.	A	G	14	6	20	0	0	20	0	0
18	6793749	.	A	G	14	5	19	0	1	20	0	0
18	24097917	.	A	G	7	4	11	0	0	11	0	0
18	24098289	.	A	G	7	3	10	0	1	11	0	0
18	24098457	.	A	G	6	4	10	0	1	11	0	0
18	25155686	.	A	G	5	2	7	2	0	9	0	0
18	32091596	.	T	C	7	2	9	0	0	9	0	0
18	32235557	.	A	G	3	3	6	0	0	6	0	0
18	32235930	.	A	G	5	6	11	0	0	11	0	0
18	32561134	.	A	G	28	10	38	0	0	38	0	0
18	32999202	.	C	T	2	2	4	0	2	6	0	0
18	35743451	.	T	C	4	2	6	0	1	7	0	0
18	35807586	.	T	C	59	11	70	0	1	71	0	0
18	36639274	.	C	T	6	3	9	0	2	11	0	0
18	36639279	.	A	T	10	1	11	0	3	14	0	0
18	40338588	.	C	T	18	4	22	0	1	23	0	0
18	43664579	.	G	T	17	3	20	0	1	21	0	0
18	57089619	.	T	C	7	2	9	1	1	11	0	0
18	57089620	.	T	C	1	7	8	1	2	11	0	0
18	57090047	.	T	C	7	3	10	0	0	10	0	0
18	57090057	.	T	C	1	8	9	0	2	11	0	0
18	62794785	.	A	G	4	3	7	0	0	7	0	0
18	64398025	.	A	C	1	3	4	0	2	6	0	0
18	64398028	.	A	C	1	1	2	0	2	4	0	0
18	64400015	.	C	G	2	2	4	0	0	4	0	0
18	68395248	.	C	T	7	2	9	0	1	10	0	0
18	75527605	.	G	T	15	3	18	0	1	19	0	0
18	77062550	.	A	G	6	6	12	0	0	12	0	0
18	77062557	.	A	G	13	3	16	0	0	16	0	0
19	3916385	.	A	G	14	3	17	0	0	17	0	0
19	3916452	.	A	G	20	4	24	0	0	24	0	0
19	3917362	.	A	G	7	4	11	1	1	13	0	0
19	3940209	.	A	G	2	2	4	0	0	4	0	0
19	4162730	.	A	T	2	1	3	0	0	3	0	0
19	4247479	.	A	G	7	2	9	0	0	9	0	0
19	4368397	.	A	G	6	3	9	0	8	17	0	0
19	4811022	.	T	C	6	2	8	0	0	8	0	0
19	4811061	.	T	C	5	3	8	0	0	8	0	0
19	4813117	.	T	C	5	2	7	0	0	7	0	0
19	4813159	.	T	C	1	2	3	0	0	3	0	0
19	5016322	.	A	G	8	4	12	1	0	13	0	0
19	6895771	.	T	C	7	2	9	0	0	9	0	0
19	6895783	.	T	C	3	7	10	0	0	10	0	0
19	7254111	.	C	T	8	8	16	1	7	24	0	0
19	7515480	.	A	G	16	3	19	0	0	19	0	0
19	8660724	.	A	G	16	3	19	0	1	20	0	0
19	8868253	.	A	G	3	2	5	0	0	5	0	0
19	8900145	.	A	G	1	4	5	0	0	5	0	0
19	8900203	.	A	G	2	2	4	0	0	4	0	0
19	10223060	.	T	C	25	47	72	0	2	74	0	0
19	10223097	.	T	C	60	9	69	0	1	70	0	0
19	12441626	.	A	G	18	5	23	0	0	23	0	0
19	16255683	.	T	C	1	3	4	0	1	5	0	0
19	22967854	.	G	C	7	2	9	0	0	9	0	0
19	26727936	.	C	T	5	1	6	0	1	7	0	0
19	28995964	.	A	G	14	7	21	0	1	22	0	0
19	28997203	.	A	G	23	6	29	0	0	29	0	0
19	38738901	.	T	C	4	2	6	0	0	6	0	0
19	41834771	.	A	G	5	1	6	1	1	8	0	0
19	43429601	.	A	G	16	17	33	0	1	34	0	0
19	43429753	.	A	G	32	7	39	0	1	40	0	0
19	43485545	.	T	C	17	4	21	0	0	21	0	0
19	43722350	.	A	C	3	2	5	0	3	8	0	0
19	44130371	.	T	C	2	3	5	0	0	5	0	0
19	47231551	.	A	C	0	2	2	0	0	2	0	0
19	47231553	.	A	C	1	0	1	0	2	3	0	0
19	60515729	.	A	G	3	3	6	0	4	10	0	0
2	14153492	.	A	G	3	10	13	0	0	13	0	0
2	14153493	.	A	G	3	10	13	0	0	13	0	0
2	14153560	.	A	G	6	3	9	0	1	10	0	0
2	14153568	.	A	G	8	8	16	0	0	16	0	0
2	18219539	.	T	C	12	3	15	0	0	15	0	0
2	18219544	.	T	C	13	2	15	0	0	15	0	0
2	18220174	.	T	C	6	5	11	0	0	11	0	0
2	22478196	.	G	A	0	2	2	3	0	5	0	0
2	22478202	.	T	C	1	2	3	4	0	7	0	0
2	24849470	.	T	G	3	3	6	0	0	6	0	0
2	24909462	.	T	C	8	2	10	0	0	10	0	0
2	26271758	.	A	G	1	2	3	0	0	3	0	0
2	27153718	.	T	C	2	3	5	0	0	5	0	0
2	29666798	.	T	C	15	4	19	3	0	22	0	0
2	29961422	.	G	A	33	19	52	14	24	90	0	0
2	30848283	.	G	A	16	5	21	0	1	22	0	0
2	30920955	.	T	C	16	4	20	0	0	20	0	0
2	31937444	.	A	G	22	4	26	1	0	27	0	0
2	32196762	.	A	G	38	6	44	0	1	45	0	0
2	32853902	.	T	A	4	2	6	0	0	6	0	0
2	34713402	.	T	C	2	2	4	0	0	4	0	0
2	49199137	.	T	C	6	2	8	128	1	137	0	0
2	50082793	.	G	A	9	4	13	0	3	16	0	0
2	50082797	.	G	A	12	5	17	0	4	21	0	0
2	55005781	.	C	T	16	2	18	0	2	20	0	0
2	55005783	.	G	T	17	2	19	0	1	20	0	0
2	59682853	.	G	T	1	3	4	0	0	4	0	0
2	59682854	.	G	T	1	2	3	0	1	4	0	0
2	68940227	.	A	C	10	2	12	0	1	13	0	0
2	68940233	.	A	C	10	2	12	0	1	13	0	0
2	69709360	.	T	C	2	2	4	0	0	4	0	0
2	76428783	.	A	C	9	4	13	0	6	19	0	0
2	77012350	.	A	C	7	1	8	0	3	11	0	0
2	77012356	.	A	C	6	3	9	0	1	10	0	0
2	91043632	.	A	G	36	7	43	1	0	44	0	0
2	91044358	.	A	G	19	3	22	0	0	22	0	0
2	92191246	.	G	A	9	2	11	0	3	14	0	0
2	102922972	.	T	C	2	2	4	0	1	5	0	0
2	104511117	.	T	C	21	7	28	0	0	28	0	0
2	104511430	.	T	C	19	5	24	0	0	24	0	0
2	112185846	.	A	G	3	2	5	0	0	5	0	0
2	112185852	.	A	G	2	2	4	0	0	4	0	0
2	118700340	.	A	G	9	1	10	0	1	11	0	0
2	118700734	.	A	G	1	3	4	0	0	4	0	0
2	118700746	.	A	G	2	2	4	0	0	4	0	0
2	121015462	.	A	G	4	2	6	0	0	6	0	0
2	121194220	.	C	A	1	2	3	0	0	3	0	0
2	121194221	.	T	A	1	2	3	0	0	3	0	0
2	124930620	.	C	A	13	2	15	2	9	26	0	0
2	125089226	.	T	C	7	1	8	0	0	8	0	0
2	125089230	.	G	C	6	1	7	0	0	7	0	0
2	126733384	.	T	C	10	3	13	0	0	13	0	0
2	126733403	.	T	C	10	2	12	0	1	13	0	0
2	126734766	.	T	C	5	8	13	0	0	13	0	0
2	126734771	.	T	C	6	4	10	0	0	10	0	0
2	127448707	.	G	A	5	2	7	0	0	7	0	0
2	130396840	.	A	G	1	7	8	0	1	9	0	0
2	130396854	.	A	G	8	2	10	0	0	10	0	0
2	130396876	.	A	G	3	4	7	0	0	7	0	0
2	130397973	.	A	G	1	7	8	0	0	8	0	0
2	130397974	.	A	G	3	4	7	0	1	8	0	0
2	130410056	.	A	G	1	2	3	0	0	3	0	0
2	130715901	.	T	C	3	2	5	0	0	5	0	0
2	132081427	.	A	G	1	1	2	1	1	4	0	0
2	132151800	.	A	G	41	266	307	0	3	310	0	0
2	132636996	.	C	A	4	2	6	0	0	6	0	0
2	135911813	.	G	A	5	2	7	0	3	10	0	0
2	152114942	.	A	G	2	10	12	0	0	12	0	0
2	153051040	.	C	A	3	5	8	0	9	24	7	0
2	153459205	.	T	C	1	1	2	0	3	5	0	0
2	153460273	.	T	C	4	2	6	0	0	6	0	0
2	153460309	.	T	C	2	5	7	0	0	7	0	0
2	153460310	.	T	C	4	3	7	0	0	7	0	0
2	154379850	.	A	G	26	5	31	0	0	31	0	0
2	154488700	.	T	C	3	2	5	0	0	5	0	0
2	155118371	.	A	C	12	2	14	0	0	14	0	0
2	157400030	.	T	C	61	23	84	7	3	94	0	0
2	158219426	.	A	G	7	3	10	0	1	11	0	0
2	158219433	.	A	G	7	2	9	0	0	9	0	0
2	158220838	.	A	G	9	3	12	0	0	12	0	0
2	158225545	.	A	G	319	49	368	0	1	369	0	0
2	158226873	.	A	G	82	314	396	0	7	403	0	0
2	163309459	.	T	C	2	9	11	0	1	12	0	0
2	163310345	.	T	C	17	5	22	0	0	22	0	0
2	164953773	.	T	C	28	10	38	0	0	38	0	0
2	169913421	.	A	G	7	3	10	0	1	11	0	0
2	174549533	.	G	C	1	2	3	0	2	5	0	0
2	177006548	.	G	A	1	10	11	2	0	13	0	0
2	177080636	.	A	G	5	1	6	4	0	10	0	0
2	181510490	.	A	G	37	6	43	0	1	44	0	0
3	26385911	.	T	C	14	3	17	0	0	17	0	0
3	32615620	.	A	G	48	16	64	0	0	64	0	0
3	32615624	.	C	T	47	28	75	0	2	77	0	0
3	32636549	.	T	C	18	6	24	0	0	24	0	0
3	40748697	.	A	G	38	12	50	9	1	60	0	0
3	41628528	.	A	G	1	2	3	0	0	3	0	0
3	45388130	.	A	G	16	3	19	0	0	19	0	0
3	54706896	.	A	G	8	3	11	0	0	11	0	0
3	59224386	.	C	T	12	3	15	0	2	17	0	0
3	60525028	.	A	C	2	2	4	0	1	5	0	0
3	60525034	.	A	C	2	2	4	0	0	4	0	0
3	65866372	.	A	G	3	1	4	0	1	5	0	0
3	80599593	.	T	C	86	207	293	0	2	295	0	0
3	80614159	.	T	C	2	8	10	0	0	10	0	0
3	80614215	.	T	C	234	107	341	0	7	348	0	0
3	85463705	.	T	C	3	3	6	0	0	6	0	0
3	87437091	.	T	C	3	2	5	0	0	5	0	0
3	88259488	.	A	G	4	4	8	0	0	8	0	0
3	88259498	.	A	G	1	8	9	0	1	10	0	0
3	88259549	.	A	G	11	5	16	0	0	16	0	0
3	88259584	.	A	G	5	2	7	0	1	8	0	0
3	88712739	.	T	C	17	7	24	0	0	24	0	0
3	89259027	.	T	C	3	2	5	0	0	5	0	0
3	89308434	.	T	C	4	3	7	0	1	8	0	0
3	89675221	.	T	C	7	2	9	0	0	9	0	0
3	89680149	.	C	T	10	2	12	0	0	12	0	0
3	89967705	.	A	G	5	5	10	0	0	10	0	0
3	90269081	.	T	C	8	1	9	0	8	17	0	0
3	90269085	.	T	C	9	1	10	0	7	17	0	0
3	90270461	.	C	T	3	3	6	0	3	9	0	0
3	94794244	.	T	A	11	3	14	0	0	14	0	0
3	94794245	.	G	A	11	3	14	0	0	14	0	0
3	95037904	.	T	C	3	2	5	0	1	6	0	0
3	95091560	.	T	C	8	3	11	0	0	11	0	0
3	95668923	.	G	C	5	2	7	0	3	10	0	0
3	95668929	.	G	C	8	1	9	0	4	13	0	0
3	96539776	.	A	G	7	23	30	0	1	31	0	0
3	101483698	.	G	C	19	10	29	0	31	60	0	0
3	102973406	.	A	G	28	12	40	0	0	40	0	0
3	104834685	.	A	G	1	7	8	0	0	8	0	0
3	104835351	.	A	G	2	3	5	0	0	5	0	0
3	104835352	.	A	G	3	2	5	0	0	5	0	0
3	104835432	.	A	G	9	3	12	0	0	12	0	0
3	116537746	.	T	C	9	7	16	0	0	16	0	0
3	116537812	.	T	C	13	3	16	1	0	17	0	0
3	116538330	.	T	C	7	10	17	0	1	19	1	0
3	116538353	.	T	C	16	8	24	0	0	24	0	0
3	138264886	.	A	G	9	5	14	0	0	14	0	0
3	138264887	.	A	G	11	3	14	0	0	14	0	0
3	138265030	.	A	G	16	3	19	0	0	19	0	0
3	151812724	.	C	T	2	1	3	0	1	4	0	0
3	152090793	.	A	G	3	2	5	0	0	5	0	0
3	156267593	.	A	G	5	3	8	0	0	8	0	0
4	9576791	.	G	A	9	6	15	0	1	16	0	0
4	21834757	.	A	G	16	6	22	0	0	22	0	0
4	21834791	.	A	G	9	10	19	0	1	20	0	0
4	21911667	.	A	G	4	2	6	0	0	6	0	0
4	33019420	.	A	G	83	34	117	0	4	121	0	0
4	33020417	.	A	G	66	54	120	0	2	122	0	0
4	41518514	.	T	C	180	36	216	0	4	220	0	0
4	43538490	.	A	G	6	2	8	0	1	9	0	0
4	45377142	.	A	G	6	3	9	0	0	9	0	0
4	55081616	.	C	A	10	3	13	0	3	16	0	0
4	56870216	.	T	C	12	2	14	0	0	14	0	0
4	56875812	.	T	C	7	4	11	0	0	11	0	0
4	59774411	.	A	G	7	2	9	0	0	9	0	0
4	62342224	.	A	G	9	4	13	0	1	14	0	0
4	76052327	.	C	T	3	1	4	0	1	5	0	0
4	76052329	.	T	C	4	1	5	0	0	5	0	0
4	83404650	.	G	A	22	7	29	1	0	30	0	0
4	86495344	.	G	T	57	15	72	0	2	75	1	0
4	94834227	.	G	A	2	2	4	1	0	5	0	0
4	103021909	.	A	G	20	4	24	0	0	24	0	0
4	107700968	.	T	C	5	3	8	0	0	8	0	0
4	107701489	.	A	G	1	2	3	0	0	3	0	0
4	108198313	.	A	G	6	3	9	0	1	10	0	0
4	115991567	.	T	C	7	2	9	0	0	9	0	0
4	116409975	.	T	C	5	2	7	0	1	8	0	0
4	118484005	.	A	G	10	22	32	0	0	32	0	0
4	118484020	.	A	G	21	10	31	0	2	33	0	0
4	118484072	.	A	G	9	6	15	0	0	15	0	0
4	119081410	.	T	C	19	3	22	1	0	23	0	0
4	119135361	.	C	T	16	23	39	0	19	58	0	0
4	119993583	.	T	C	7	6	13	0	2	15	0	0
4	119993589	.	T	C	6	7	13	0	0	13	0	0
4	123127621	.	A	G	1	1	2	0	0	2	0	0
4	123140820	.	A	G	3	1	4	0	0	4	0	0
4	124837154	.	A	G	20	4	24	0	0	24	0	0
4	124838094	.	A	G	9	11	20	0	2	22	0	0
4	124838166	.	A	G	10	2	12	0	0	12	0	0
4	124838169	.	A	G	10	4	14	0	0	14	0	0
4	125982944	.	A	G	8	7	15	0	0	15	0	0
4	125982989	.	A	G	11	4	15	0	0	15	0	0
4	125985370	.	A	G	7	4	11	0	0	11	0	0
4	125985374	.	A	G	8	5	13	0	0	13	0	0
4	125985458	.	A	G	11	3	14	0	1	15	0	0
4	126929461	.	G	T	20	5	25	2	1	28	0	0
4	129107038	.	A	G	2	3	5	0	0	5	0	0
4	131839525	.	T	C	16	4	20	0	0	20	0	0
4	131913925	.	C	A	9	3	12	0	2	14	0	0
4	133389520	.	T	C	3	2	5	0	0	5	0	0
4	137934374	.	T	A	3	2	5	0	0	5	0	0
4	137987341	.	A	G	79	18	97	0	3	100	0	0
4	137987354	.	A	G	73	26	99	0	1	100	0	0
4	138184300	.	A	G	6	5	11	0	0	11	0	0
4	144619861	.	C	T	6	2	8	0	0	8	0	0
4	147907770	.	T	C	2	4	6	0	0	6	0	0
4	147907775	.	T	C	2	4	6	0	0	6	0	0
4	147909430	.	T	C	3	2	5	0	0	5	0	0
4	149202586	.	A	G	26	4	30	0	0	30	0	0
4	149202605	.	A	G	29	5	34	0	0	34	0	0
4	149202654	.	A	G	19	6	25	0	2	27	0	0
4	149203211	.	A	G	12	7	19	0	0	19	0	0
4	149552818	.	T	C	3	2	5	0	0	5	0	0
4	151089106	.	G	A	3	5	8	0	1	9	0	0
4	151089109	.	G	A	3	5	8	0	0	8	0	0
4	155705891	.	A	G	11	3	14	0	1	15	0	0
4	155705927	.	A	G	13	3	16	0	2	18	0	0
4	155705982	.	A	G	14	3	17	0	1	18	0	0
4	155800341	.	A	G	13	2	15	0	0	15	0	0
4	155800935	.	A	G	6	2	8	0	0	8	0	0
4	155800978	.	A	G	8	4	12	0	0	12	0	0
4	156095123	.	A	G	61	46	107	0	0	107	0	0
4	156105693	.	T	C	4	3	7	0	0	7	0	0
5	3680495	.	T	C	5	2	7	0	0	7	0	0
5	3680498	.	T	C	5	3	8	0	0	8	0	0
5	5833142	.	A	G	2	2	4	6	3	13	0	0
5	14730250	.	C	T	3	1	4	0	0	4	0	0
5	22733550	.	C	T	1	2	3	3	0	6	0	0
5	22930275	.	T	C	2	4	6	0	0	6	0	0
5	22930543	.	T	C	1	2	3	1	0	4	0	0
5	22930643	.	A	G	1	2	3	3	1	7	0	0
5	23696451	.	A	G	5	2	7	0	0	7	0	0
5	24649804	.	T	C	3	14	17	1	0	18	0	0
5	24649822	.	T	C	13	8	21	1	0	22	0	0
5	25430722	.	A	G	7	3	10	0	1	11	0	0
5	26212328	.	A	T	1	2	3	0	0	3	0	0
5	29435627	.	T	C	18	5	23	0	0	23	0	0
5	29658129	.	A	G	2	3	5	0	0	5	0	0
5	30781303	.	A	T	10	3	13	0	1	14	0	0
5	31026137	.	A	G	2	2	4	0	0	4	0	0
5	31234722	.	G	A	7	2	9	0	0	9	0	0
5	33149571	.	A	G	8	2	10	0	0	10	0	0
5	33149755	.	A	G	10	4	14	0	0	14	0	0
5	33149943	.	A	G	5	4	9	0	0	9	0	0
5	33573313	.	A	G	5	2	7	0	0	7	0	0
5	33575654	.	A	G	2	2	4	0	0	4	0	0
5	33575661	.	A	G	3	2	5	0	0	5	0	0
5	33575750	.	A	G	6	2	8	0	0	8	0	0
5	34831890	.	G	C	8	2	10	0	0	10	0	0
5	36157689	.	C	T	4	4	8	0	1	9	0	0
5	36159635	.	A	G	12	4	16	0	0	16	0	0
5	45741499	.	A	G	8	2	10	0	0	10	0	0
5	65605388	.	T	C	44	10	54	0	0	54	0	0
5	65605389	.	T	C	28	23	51	0	3	54	0	0
5	65765485	.	A	G	7	4	11	2	0	13	0	0
5	69266842	.	T	A	3	1	4	0	1	5	0	0
5	73469787	.	A	G	61	10	71	0	1	72	0	0
5	74159338	.	C	T	9	2	11	0	1	12	0	0
5	77555578	.	T	C	5	21	26	0	0	26	0	0
5	91771853	.	C	A	15	5	20	0	2	22	0	0
5	110081429	.	C	T	4	2	6	0	0	6	0	0
5	110081431	.	C	T	5	2	7	0	0	7	0	0
5	110226520	.	A	G	1	4	5	3	0	8	0	0
5	111371204	.	A	G	7	2	9	0	0	9	0	0
5	113058357	.	A	G	4	2	6	0	0	6	0	0
5	114866901	.	T	C	7	2	9	0	2	11	0	0
5	115241332	.	T	C	1	2	3	3	0	6	0	0
5	121269618	.	A	C	2	1	3	0	1	4	0	0
5	121269624	.	T	C	3	2	5	0	0	5	0	0
5	121659276	.	C	T	7	2	9	0	0	9	0	0
5	121662316	.	T	C	5	2	7	0	0	7	0	0
5	121683511	.	T	C	13	3	16	0	1	17	0	0
5	121997242	.	C	A	7	2	9	0	0	9	0	0
5	121998046	.	C	A	14	4	18	0	3	21	0	0
5	122312331	.	T	C	4	2	6	118	0	124	0	0
5	122546790	.	A	G	12	4	16	0	0	16	0	0
5	122872763	.	T	C	12	2	14	0	0	14	0	0
5	123386729	.	A	G	9	9	18	0	0	18	0	0
5	123510674	.	G	T	6	4	10	0	0	10	0	0
5	123879315	.	T	C	1	5	6	0	0	6	0	0
5	123880129	.	T	C	3	3	6	0	0	6	0	0
5	123880130	.	T	C	3	3	6	0	0	6	0	0
5	125354299	.	C	G	13	3	16	0	0	16	0	0
5	125533669	.	A	G	23	47	70	0	0	70	0	0
5	125533970	.	A	G	45	11	56	0	0	56	0	0
5	125534541	.	A	G	43	31	74	0	1	75	0	0
5	129795821	.	A	G	6	9	15	0	1	16	0	0
5	129795880	.	A	G	20	5	25	0	0	25	0	0
5	129797823	.	A	G	13	17	30	0	2	32	0	0
5	130014307	.	A	G	51	8	59	0	0	59	0	0
5	131336191	.	A	C	10	2	12	0	5	17	0	0
5	134627305	.	A	G	1	2	3	0	0	3	0	0
5	135193588	.	A	G	2	2	4	0	0	4	0	0
5	135437709	.	T	C	18	12	30	0	2	32	0	0
5	135437715	.	T	C	23	8	31	0	0	31	0	0
5	136941953	.	A	G	71	22	93	1	0	94	0	0
5	136995082	.	T	C	16	4	20	0	0	20	0	0
5	137336162	.	T	C	4	2	6	0	1	7	0	0
5	138363461	.	G	A	0	1	1	2	2	5	0	0
5	142647038	.	T	C	3	1	4	0	1	5	0	0
5	142647043	.	T	C	2	2	4	0	0	4	0	0
5	142655030	.	A	G	88	16	104	0	3	107	0	0
5	142655047	.	A	G	82	22	104	0	1	105	0	0
5	142856760	.	T	C	19	4	23	0	0	23	0	0
5	143751066	.	A	G	11	3	14	0	0	14	0	0
5	150526358	.	T	C	9	2	11	0	0	11	0	0
5	150571797	.	T	C	2	2	4	0	0	4	0	0
6	18427884	.	C	A	2	2	4	0	1	5	0	0
6	24953649	.	G	A	47	8	55	0	5	60	0	0
6	31486635	.	A	C	8	6	14	0	4	18	0	0
6	31486641	.	G	C	12	6	18	0	2	20	0	0
6	31492602	.	A	G	11	5	16	0	0	16	0	0
6	31492665	.	A	G	11	4	15	0	1	16	0	0
6	37847782	.	A	G	13	3	16	0	0	16	0	0
6	38265837	.	T	C	8	3	11	0	0	11	0	0
6	39312088	.	T	C	27	8	35	0	0	35	0	0
6	39312096	.	T	C	28	6	34	0	0	34	0	0
6	42301409	.	C	T	32	37	69	0	5	74	0	0
6	47773202	.	G	A	1	2	3	0	2	5	0	0
6	47846415	.	A	G	12	6	18	0	0	18	0	0
6	47848349	.	A	G	12	4	16	0	1	17	0	0
6	47848373	.	A	G	9	4	13	0	0	13	0	0
6	47848389	.	A	G	9	2	11	0	0	11	0	0
6	47848659	.	A	G	2	12	14	0	0	14	0	0
6	47848676	.	A	G	9	3	12	0	1	13	0	0
6	47848942	.	A	G	7	2	9	0	0	9	0	0
6	47924523	.	A	G	1	3	4	0	0	4	0	0
6	47924530	.	A	G	1	3	4	0	0	4	0	0
6	49231811	.	T	C	13	3	16	0	0	16	0	0
6	49231812	.	T	C	11	6	17	0	0	17	0	0
6	49237955	.	T	C	17	5	22	0	0	22	0	0
6	49237956	.	T	C	17	5	22	0	0	22	0	0
6	57512427	.	T	A	8	3	11	0	4	15	0	0
6	65684423	.	A	G	2	5	7	0	0	7	0	0
6	65684442	.	A	G	2	4	6	0	0	6	0	0
6	65687589	.	A	G	5	3	8	0	0	8	0	0
6	66517065	.	A	G	2	2	4	0	0	4	0	0
6	66517110	.	A	G	6	3	9	0	0	9	0	0
6	66517625	.	A	G	3	3	6	0	1	7	0	0
6	66517635	.	A	G	8	2	10	0	0	10	0	0
6	84790053	.	T	G	1	3	4	1	0	5	0	0
6	85932353	.	T	C	7	5	12	0	1	13	0	0
6	87869815	.	A	G	7	2	9	0	0	9	0	0
6	91732491	.	G	A	35	14	49	1	1	51	0	0
6	96010183	.	T	C	7	2	9	4	0	13	0	0
6	110617307	.	T	C	1	3	4	0	0	4	0	0
6	115818036	.	T	C	6	2	8	0	0	8	0	0
6	120420154	.	A	G	2	2	4	0	0	4	0	0
6	120420155	.	A	G	2	2	4	0	0	4	0	0
6	122294760	.	A	G	10	3	13	0	0	13	0	0
6	126619121	.	T	C	51	31	82	0	4	86	0	0
6	127102705	.	G	T	5	4	9	1	4	14	0	0
6	127470543	.	A	C	2	3	5	0	0	5	0	0
6	128299471	.	C	A	11	2	13	0	0	13	0	0
6	134835326	.	C	T	9	4	13	0	1	14	0	0
6	146733792	.	A	G	1	2	3	0	0	3	0	0
6	146734488	.	G	T	3	2	5	0	0	5	0	0
6	148786133	.	T	C	5	2	7	0	0	7	0	0
6	149052371	.	A	G	3	2	5	0	0	5	0	0
7	3463600	.	A	G	66	18	84	0	3	87	0	0
7	3613131	.	T	C	2	2	4	0	1	5	0	0
7	6967909	.	A	G	4	4	8	0	0	8	0	0
7	6967962	.	A	G	10	6	16	0	1	17	0	0
7	6967965	.	A	G	6	12	18	0	0	18	0	0
7	6968013	.	A	G	5	6	11	0	0	11	0	0
7	6969513	.	A	G	7	14	21	0	0	21	0	0
7	12212392	.	A	G	10	3	13	0	0	13	0	0
7	12601882	.	T	C	1	3	4	0	0	4	0	0
7	15864164	.	G	C	6	7	13	0	17	30	0	0
7	15864170	.	T	C	8	13	21	0	8	29	0	0
7	16619450	.	A	G	13	3	16	0	0	16	0	0
7	16619714	.	A	G	67	16	83	0	2	85	0	0
7	18767190	.	A	G	1	2	3	0	0	3	0	0
7	18873686	.	T	C	9	2	11	0	0	11	0	0
7	18873733	.	T	C	6	2	8	0	0	8	0	0
7	18886836	.	A	G	1	7	8	0	0	8	0	0
7	19326753	.	A	G	1	11	12	0	0	12	0	0
7	19638449	.	T	A	1	5	6	0	0	6	0	0
7	19638461	.	T	A	4	2	6	0	0	6	0	0
7	23898508	.	G	T	1	6	7	0	0	7	0	0
7	24710068	.	T	C	88	28	116	0	0	116	0	0
7	24710075	.	T	C	80	32	112	0	1	113	0	0
7	25319927	.	T	A	1	1	2	0	2	4	0	0
7	26904993	.	A	G	3	6	9	0	0	9	0	0
7	26905060	.	A	G	2	4	6	0	0	6	0	0
7	26905759	.	A	G	4	2	6	0	0	6	0	0
7	27520956	.	A	G	5	9	14	0	0	14	0	0
7	28922269	.	T	C	4	2	6	0	0	6	0	0
7	45032973	.	T	C	6	4	10	0	1	11	0	0
7	45140801	.	T	C	1	4	5	0	0	5	0	0
7	45141114	.	T	C	2	3	5	0	0	5	0	0
7	45288447	.	C	A	1	3	4	0	1	5	0	0
7	55575241	.	A	G	2	2	4	0	0	4	0	0
7	55627368	.	T	C	54	21	75	0	0	75	0	0
7	55628136	.	T	C	17	4	21	0	0	21	0	0
7	58875215	.	T	C	6	3	9	0	0	9	0	0
7	58879117	.	G	A	4	1	5	0	0	5	0	0
7	58879122	.	G	C	5	1	6	0	0	6	0	0
7	58972376	.	T	C	1	2	3	0	0	3	0	0
7	58979279	.	T	C	5	2	7	0	0	7	0	0
7	59331191	.	G	C	5	2	7	12	0	19	0	0
7	59331194	.	A	C	5	2	7	12	0	19	0	0
7	61355071	.	T	C	2	2	4	0	0	4	0	0
7	61589842	.	T	C	4	2	6	0	0	6	0	0
7	79574207	.	T	C	4	3	7	0	0	7	0	0
7	79875818	.	G	T	6	2	8	0	0	8	0	0
7	79875819	.	G	T	5	2	7	0	1	8	0	0
7	81253540	.	T	C	21	5	26	0	1	27	0	0
7	81521958	.	A	G	3	3	6	0	0	6	0	0
7	81522050	.	A	G	5	2	7	0	0	7	0	0
7	81522943	.	A	G	2	2	4	0	0	4	0	0
7	83274886	.	T	C	7	3	10	0	0	10	0	0
7	83758569	.	A	G	3	2	5	0	0	5	0	0
7	98250295	.	C	T	2	1	3	0	1	4	0	0
7	98969304	.	A	G	20	7	27	0	1	28	0	0
7	98969425	.	C	A	14	2	16	0	4	20	0	0
7	98969431	.	C	A	15	5	20	0	4	24	0	0
7	105388653	.	A	G	6	2	8	0	0	8	0	0
7	113639293	.	A	T	18	4	22	1	6	29	0	0
7	120273215	.	T	C	8	2	10	0	0	10	0	0
7	120273216	.	T	C	8	2	10	0	0	10	0	0
7	120527730	.	C	T	24	3	27	0	1	28	0	0
7	120527731	.	A	G	23	3	26	0	1	27	0	0
7	121586870	.	T	C	3	3	6	0	0	6	0	0
7	126423019	.	G	C	11	6	17	0	3	20	0	0
7	126423022	.	A	C	16	6	22	0	0	22	0	0
7	126853494	.	A	G	29	12	41	0	0	41	0	0
7	126853784	.	A	G	46	7	53	0	0	53	0	0
7	127165851	.	A	G	1	3	4	0	0	4	0	0
7	127178219	.	A	G	4	2	6	0	0	6	0	0
7	127178234	.	A	G	1	3	4	0	0	4	0	0
7	127385246	.	G	C	2	3	5	0	0	5	0	0
7	130360893	.	A	T	4	6	10	0	0	10	0	0
7	131588479	.	A	C	11	2	13	0	1	14	0	0
7	139685712	.	T	C	17	4	21	0	0	21	0	0
7	140390969	.	T	C	14	3	17	0	0	17	0	0
7	140391023	.	T	C	11	5	16	0	1	17	0	0
7	140456002	.	T	C	2	2	4	0	0	4	0	0
7	140916604	.	A	G	25	8	33	0	1	34	0	0
7	141052266	.	C	G	3	2	5	0	0	5	0	0
7	141107290	.	T	C	7	2	9	0	0	9	0	0
7	141503671	.	G	C	16	0	16	2	0	18	0	0
7	142207010	.	T	C	15	13	28	0	0	28	0	0
7	142766905	.	T	C	4	2	6	0	0	6	0	0
8	5690780	.	A	G	0	2	2	6	1	9	0	0
8	14077909	.	G	T	3	2	5	0	1	6	0	0
8	14949868	.	C	T	5	1	6	0	0	6	0	0
8	19732474	.	C	A	14	4	18	0	0	18	0	0
8	19741629	.	C	T	3	2	5	10	0	15	0	0
8	19834807	.	A	T	17	3	20	34	0	54	0	0
8	20030855	.	G	A	17	4	21	5	0	26	0	0
8	20157964	.	A	G	5	2	7	40	0	47	0	0
8	20158095	.	C	T	1	2	3	57	0	60	0	0
8	20721217	.	A	G	5	2	7	13	0	20	0	0
8	20727130	.	G	A	22	14	36	2	0	38	0	0
8	26642508	.	A	G	2	2	4	0	0	4	0	0
8	34089856	.	G	A	1	1	2	0	0	2	0	0
8	37462043	.	T	C	3	3	6	0	0	6	0	0
8	41370800	.	A	G	11	2	13	0	0	13	0	0
8	42061914	.	T	C	2	2	4	1	0	5	0	0
8	67158789	.	C	A	1	12	13	0	2	15	0	0
8	70028770	.	G	A	1	8	9	2	0	11	0	0
8	70784599	.	G	A	7	6	13	0	15	28	0	0
8	71826392	.	A	G	5	2	7	0	0	7	0	0
8	72977426	.	A	G	11	25	36	0	1	37	0	0
8	73236518	.	T	C	73	11	84	0	1	85	0	0
8	78322637	.	G	A	9	2	11	0	0	11	0	0
8	81707521	.	A	G	2	2	4	0	0	4	0	0
8	84976646	.	T	C	1	3	4	0	0	4	0	0
8	84982543	.	T	C	2	7	9	0	0	9	0	0
8	84982544	.	T	C	5	4	9	0	0	9	0	0
8	94743327	.	T	C	6	2	8	40	1	49	0	0
8	94743965	.	T	C	6	2	8	4	2	14	0	0
8	96099873	.	G	C	5	2	7	0	0	7	0	0
8	107299725	.	A	G	1	2	3	1	0	4	0	0
8	107744427	.	A	G	12	5	17	0	0	17	0	0
8	107744848	.	A	G	6	6	12	0	0	12	0	0
8	110401697	.	T	C	2	2	4	0	0	4	0	0
8	110817217	.	A	G	25	11	36	0	1	37	0	0
8	112680137	.	A	G	24	5	29	0	0	29	0	0
8	112693652	.	T	C	5	2	7	0	0	7	0	0
8	123008946	.	C	T	3	1	4	0	0	4	0	0
8	124625664	.	G	A	7	2	9	0	0	9	0	0
8	125620861	.	T	C	23	7	30	0	0	30	0	0
8	125620868	.	T	C	27	6	33	0	1	34	0	0
8	125620923	.	T	C	10	20	30	0	0	30	0	0
8	125620929	.	T	C	17	8	25	0	0	25	0	0
9	3387771	.	A	G	17	4	21	0	1	22	0	0
9	3387790	.	A	G	18	3	21	0	0	21	0	0
9	4456006	.	T	C	4	17	21	1	0	22	0	0
9	8022080	.	T	C	11	3	14	0	1	15	0	0
9	20507654	.	T	G	4	2	6	0	0	6	0	0
9	20511950	.	A	G	4	3	7	0	0	7	0	0
9	20512443	.	A	G	3	3	6	0	0	6	0	0
9	20512857	.	A	G	7	3	10	0	0	10	0	0
9	20512920	.	A	G	9	2	11	0	0	11	0	0
9	20513253	.	A	G	6	3	9	0	0	9	0	0
9	20513879	.	A	G	1	2	3	0	0	3	0	0
9	20515384	.	A	G	3	2	5	0	0	5	0	0
9	20515808	.	A	G	2	4	6	0	0	6	0	0
9	21122912	.	G	A	23	13	36	0	7	43	0	0
9	21199758	.	C	T	2	2	4	0	0	4	0	0
9	21929088	.	C	T	11	4	15	0	6	21	0	0
9	37164467	.	T	C	0	1	1	11	2	14	0	0
9	37560490	.	A	G	5	2	7	0	0	7	0	0
9	43957544	.	A	G	5	2	7	0	0	7	0	0
9	44203921	.	T	C	10	2	12	0	0	12	0	0
9	44204075	.	T	C	17	6	23	0	0	23	0	0
9	44206135	.	T	C	12	3	15	0	0	15	0	0
9	44206372	.	T	C	8	2	10	0	0	10	0	0
9	50519250	.	A	G	1	1	2	0	1	3	0	0
9	50519427	.	A	G	3	2	5	0	0	5	0	0
9	54275803	.	G	T	5	2	7	0	0	7	0	0
9	54275804	.	G	T	5	2	7	0	0	7	0	0
9	60595379	.	C	G	10	2	12	0	0	12	0	0
9	64142628	.	G	A	1	2	3	0	0	3	0	0
9	64142635	.	T	C	1	2	3	0	0	3	0	0
9	65253476	.	A	G	7	2	9	0	0	9	0	0
9	66280825	.	A	G	2	2	4	0	0	4	0	0
9	67127254	.	T	C	16	3	19	0	0	19	0	0
9	67892060	.	C	T	10	6	16	0	0	16	0	0
9	67892066	.	C	T	10	5	15	0	1	16	0	0
9	69923121	.	A	G	6	3	9	0	0	9	0	0
9	69923122	.	A	G	4	3	7	0	0	7	0	0
9	72270786	.	C	A	13	7	20	0	8	28	0	0
9	73387872	.	G	T	7	8	15	0	2	17	0	0
9	73387877	.	C	T	8	4	12	0	3	15	0	0
9	75411333	.	A	G	4	2	6	0	0	6	0	0
9	79351592	.	T	C	2	5	7	0	0	7	0	0
9	88724645	.	T	C	3	2	5	0	0	5	0	0
9	88724652	.	T	C	3	2	5	0	0	5	0	0
9	89097312	.	A	G	11	2	13	1	1	15	0	0
9	95448061	.	C	T	10	3	13	0	1	14	0	0
9	95938130	.	A	G	14	4	18	0	0	18	0	0
9	95938187	.	A	G	4	4	8	0	0	8	0	0
9	95938188	.	A	G	6	2	8	0	0	8	0	0
9	95939293	.	A	G	15	4	19	0	0	19	0	0
9	96187692	.	A	G	1	2	3	0	0	3	0	0
9	96187702	.	A	G	1	1	2	0	0	2	0	0
9	96778071	.	T	C	3	2	5	77	0	82	0	0
9	110086210	.	A	G	6	2	8	0	0	8	0	0
9	110090640	.	T	C	4	2	6	0	0	6	0	0
9	110091127	.	G	A	12	2	14	0	0	14	0	0
9	110723184	.	C	T	5	1	6	0	0	6	0	0
9	121510177	.	G	A	4	3	7	2	0	9	0	0
9	121540643	.	C	T	3	1	4	0	1	5	0	0
9	121540649	.	A	C	3	2	5	0	0	5	0	0
9	121540697	.	A	G	5	2	7	0	0	7	0	0
9	122660878	.	A	C	6	0	6	0	8	14	0	0
9	122660884	.	A	C	8	4	12	0	3	15	0	0
9	122849555	.	C	T	5	1	6	0	0	6	0	0
9	122849556	.	C	T	6	1	7	0	0	7	0	0
9	123525510	.	G	A	7	3	10	0	4	14	0	0
9	124034058	.	T	G	17	8	25	0	0	25	0	0
X	7774398	.	A	G	4	2	6	0	0	6	0	0
X	37698807	.	A	G	7	2	9	0	0	9	0	0
X	52045173	.	C	T	11	4	15	0	4	19	0	0
X	55633003	.	T	C	29	8	37	0	0	37	0	0
X	56429832	.	C	A	15	3	18	0	3	21	0	0
X	60231705	.	A	G	13	15	28	0	0	28	0	0
X	60829114	.	G	A	2	2	4	3	0	7	0	0
X	69388256	.	T	C	44	8	52	0	0	52	0	0
X	69388288	.	T	C	142	32	174	1	3	178	0	0
X	73270255	.	T	C	7	4	11	0	1	12	0	0
X	73270468	.	T	C	12	8	20	0	0	20	0	0
X	73328559	.	A	G	4	2	6	0	0	6	0	0
X	85786500	.	A	G	4	2	6	0	0	6	0	0
X	102620099	.	T	C	2	10	12	1	0	13	0	0
X	102620158	.	T	C	4	10	14	1	0	15	0	0
X	102620159	.	T	C	5	9	14	1	0	15	0	0
X	102623385	.	T	C	5	4	9	0	0	9	0	0
X	103617824	.	A	C	7	2	9	0	0	9	0	0
X	119819641	.	C	T	9	3	12	0	0	12	0	0
X	133489379	.	T	C	2	6	8	0	0	8	0	0
X	133489405	.	T	C	4	4	8	0	0	8	0	0
X	133490062	.	T	C	7	2	9	0	0	9	0	0
X	135882392	.	C	T	3	2	5	0	0	5	0	0
X	149766871	.	T	C	29	8	37	1	7	45	0	0
X	149767260	.	T	C	135	18	153	1	4	158	0	0
X	149767614	.	T	C	64	48	112	1	5	118	0	0
X	158197723	.	G	A	6	1	7	0	3	10	0	0
X	161572232	.	T	C	11	3	14	0	0	14	0	0
X	164972992	.	A	G	3	3	6	1	0	7	0	0
